!!ATOK_TANGO_TEXT_HEADER_1
!!一覧出力
!!対象辞書;C:\Users\jun\AppData\Roaming\Justsystem\Atok24\ATOK24U1.DIC
!!単語種類;登録単語(*) 自動登録単語($)
!!読み範囲;(読みの先頭) → (読みの最終)
!!出力日時;13/06/14 12:59

％うぉー	％ウォー	名詞サ変*
０ｏ	0o	名詞サ変*
１	?	単漢字$
１	１	数詞$
１	Ⅰ	数詞$
１２	ⅠⅡ	名詞サ変*
１２３	ⅠⅡⅢ	名詞サ変*
１８きん	18禁	名詞ザ変*
１みり	１ミリ	名詞サ変*
２か	2日	名詞*
３か	3日	名詞*
４たい	４対	名詞サ変$
７８	⑦⑧	名詞サ変$
８７け	８７ケ	名詞サ変*
：あねは	：アネハ	名詞*
＝＝＝＝ほ	＝＝＝＝ホ	名詞サ変*
＠Ｍ１	j1981_1@nifty.com	名詞*
＠ｍ１	j1981_1@nifty.com	名詞*
ＡＶかんしょう	ＡＶ鑑賞	名詞サ変*
ＢＬけい	ＢＬ系	名詞*
Ｂｅｈａｖｅ	Behave	名詞サ変*
Ｂさく	B作	名詞*
ＣＧきょうそう	ＣＧ競争	名詞サ変*
ＣＧぎじゅつ	ＣＧ技術	名詞*
ＣＰＵしようりつ	CPU使用率	名詞*
Ｄあくしょん	Ｄアクション	名詞サ変*
ＦＦか	ＦＦ化	名詞サ変*
ＦＦしょく	ＦＦ色	名詞*
ＧＢばん	ＧＢ版	名詞*
ＧＵＮ	ガン	名サ形動*
ＧＵＮどう	ガン道	名詞*
ＨＰぶーすと	ＨＰブースト	名詞サ変*
ＨＲばったー	ＨＲバッター	名詞サ変*
Ｈいべんと	Ｈイベント	名詞サ変*
ＩＣＯすたじお	ＩＣＯスタジオ	名詞サ変*
ＫＹＮまん	ＫＹＮマン	名詞サ変*
Ｌじ	Ｌ字	名詞*
ＭＯあねき	MO姉貴	名詞*
Ｍじ	Ｍ字	名詞*
ＮＧわーど	ＮＧワード	名詞サ変*
ＯＪしんぷそんも	ＯＪシンプソンモ	名詞サ変*
ＯＰきょく	ＯＰ曲	名詞*
ＰＡＤ	パッド	名サ形動*
ＰＡＤは	パッド派	名詞*
ＰＣばん	ＰＣ版	名詞*
ＰＳいこう	ＰＳ以降	名詞*
ＰＳしょき	ＰＳ初期	名詞*
Ｒ	ｒ	名詞サ変*
ＲＰＧつくーる	ＲＰＧツクール	名詞サ変*
ＳＥＸしーん	ＳＥＸシーン	名詞サ変*
ＳＭじょおう	ＳＭ女王	名詞*
ＳＴＧじたい	ＳＴＧ自体	名詞*
Ｓｅｅｄしけん	Seed試験	名詞サ変*
Ｓすきる	Ｓスキル	名詞サ変*
ＴＡＳどうが	TAS動画	名詞*
Ｖけい	Ｖ系	名詞*
Ｗ	w	名詞サ変*
Ｗ	W	名詞サ変*
Ｗ	ｗ	名詞サ変*
ＷＷ	ww	名詞サ変*
ＷＷＷ	www	名詞サ変*
ＷＷＷＷＷ	wwwww	名詞サ変*
Ｘ３	Ｘ３	名詞サ変*
ｃｈｄｄｓｋ	chddsk	名詞サ変*
ｃｒｙｓｔａｌｍａｒｋ	crystalmark	名詞サ変*
ｃいｖ３	ｃｉｖ３	名詞サ変$
ｃおっめんｔ	コメント	名サ形動$
ｃおんてんちおん	ｃｏｎｔｅｎｔｉｏｎ	名詞サ変$
ｃげんご	ｃ言語	名詞*
ｄｂ	ｄｂ	名詞サ変*
ｄりーむまっち	ｄリームマッチ	名詞サ変$
ｆｉｒｅｆｏｘ	firefox	名詞サ変*
ｈんと	ｈント	名詞*
ｍ	m	名詞サ変$
ｍ１	j1981_1@nifty.com	名詞*
ｍ２	j1981_1@msn.com	名詞*
ｍｒ	ミスター	名サ形動$
ｍえゆぬわ	mｴﾕﾇﾜ	名詞サ変*
ｒほ	ロー	名サ形動$
ｓａ	ｓａ	名詞サ変*
ｓａｓａｓａｓａｓａｓａｓａｓａｓａｓａｓｓｓａｓａｓａｓａｓ	ｓａｓａｓａｓａｓａｓａｓａｓａｓａｓａｓｓｓａｓａｓａｓａｓ	名詞サ変*
ｓか	スカ	名サ形動$
ｓき	スキー	名サ形動$
ｔａｋｅ２	ｔａｋｅ２	名詞サ変*
ｔｒｉｍ	trim	名詞サ変*
ｘｐ	xp	名詞サ変*
ｘがぎそん	ｘガギソン	名詞サ変*
ｘのーむ	ｘノーム	名詞サ変*
ｘまから	ｘマカラ	名詞サ変*
・	？	名詞*
・	・	名詞*
・	･	名詞$
・・・えｔｃ	･･･ｴtc	名詞サ変$
・あき	・アキ	名詞サ変$
・いーう゛ぉ	・イーヴォ	名詞サ変$
・おちんこ	・オチンコ	名詞サ変$
・がり	・ガリ	名詞サ変$
・ぎあ	・ギア	名詞サ変*
・くらい	・クライ	名サ形動*
・ざ・	・ザ・	名詞サ変$
・じょんそん	・ジョンソン	名詞サ変*
・じすかる	・ジスカル	名詞サ変*
・でぃけんず	・ディケンズ	名詞サ変$
・でぃらん	・ディラン	名詞サ変*
・でる	・デル	名詞サ変*
・ともだち	・トモダチ	名詞サ変$
・とれ	・トレ	名詞サ変$
・ぬ	・ヌ	名詞サ変*
・はる	・ハル	名詞サ変*
・ぱんちあうと	・パンチアウト	名詞サ変$
・ぷらんと	・プラント	名詞サ変$
・ぷれすりー	・プレスリー	名詞サ変$
・べる	・ベル	名詞サ変*
・ませらってぃ	・マセラッティ	名詞サ変$
・まるてぃねす	・マルティネス	名詞サ変*
・らいあん	・ライアン	名詞サ変*
・ろーず	・ローズ	名詞サ変*
をる	ヲル	名詞サ変$
ぁ	ァ	名詞サ変*
ぁん	ァン	名サ形動*
ぃみし	END	名サ形動*
ぇ	ェ	名詞サ変*
ぉいぬ	ォイヌ	名詞サ変*
ぉるだ	ォルダ	名詞サ変*
ゃちゃー	ャチャー	名詞サ変*
ゅょ	（）	名詞*
ゅょ	ュョ	名詞サ変*
っっｗ	ｗｗｗ	名詞サ変$
っっｗ	www	名詞サ変$
っっっｗ	ｗｗｗｗ	名詞サ変$
っきゃら	ッキャラ	名サ形動*
っきー	ッキー	名サ形動*
っきらい	っ嫌い	名詞形動*
っく	ック	名詞サ変*
っくる	ックル	名サ形動*
っこ	ッコ	名詞サ変*
っごいねる	ッゴイネル	名詞サ変*
っし	ッシ	名詞サ変$
っしゅ	ッシュ	名サ形動*
っしゅ	っしゅ	名詞サ変*
ったい	ッタイ	名サ形動*
って	ッテ	名詞サ変$
ってぃ	ッティ	名サ形動*
ってかんじ	って漢字	名詞*
ってかんじ	ってかんじ	名詞サ変*
ってかんじ	って感じ	名詞サ変*
ってこめんと	ッテコメント	名詞サ変*
ってふくすう	って複数	名詞*
っでん	ッデン	名サ形動*
っぷ	ップ	名サ形動*
っぷ	っぷ	名詞サ変*
あｈ	アー	名サ形動$
あｍ	エーエム	名サ形動$
あｓ・ｒ	ｱs･r	名詞サ変$
あｓ・ｒ	ａｓ／ｒ	名詞サ変$
あｖ	アｖ	名詞サ変$
あｖ	ａｖ	名詞サ変$
あ～	あ＾～	名詞*
あっ	アッー！	名詞*
あっー	アッー	名サ形動*
あっー	アッー	名詞サ変*
あっー	あっー	名詞サ変*
あっあっ	ｱｯｱｯ	名詞サ変$
あっあっあっー	アッアッアッー	名詞サ変$
あっていら	アッテイラ	名サ形動*
あっぷでき	アップ出来	一段動詞$
あー	アー	名詞サ変*
あーっ	アーッ	名詞サ変*
あーいきそ	ｱｰｲｷｿ	名詞サ変$
あーうち	アーウチ	名詞サ変$
あーう゛ぁいん	アーヴァイン	名詞サ変*
あーくえんじぇる	アークエンジェル	名詞サ変*
あーくめいじ	アークメイジ	名サ形動*
あーけーど	ｱｰｹｰﾄﾞ	名詞*
あーさー	アーサー	名詞サ変*
あーしーず	アーシーズ	名詞サ変*
あーしにそ	ｱｰｼﾆｿ	名詞サ変$
あーすひーる	アースヒール	名詞サ変$
あーち	アーチ	名詞サ変*
あーちゃー	アーチャー	名サ形動*
あーちどろわー	アーチドロワー	名詞サ変*
あーまー	アーマー	名詞サ変*
あーまーん	アーマーン	名詞サ変*
あーむぼんでーじ	アームボンデージ	名詞サ変*
あーむりかばりー	アームリカバリー	名詞サ変*
あーるきんぐ	アールキング	名詞サ変*
ああ	亜亜	名詞*
ああ	ああ＾～	名詞*
あい	アイ	名詞サ変*
あいあいだいす	アイアイダイス	名詞サ変$
あいう	アイウ	名詞サ変*
あいえき	愛液	名詞$
あいぎう	アイギウ	名サ形動*
あいぎす	アイギス	名サ形動*
あいく	アイク	名詞サ変*
あいこら	アイコラ	名サ形動*
あいしゃ	愛者	名詞*
あいじん	あいじん	名詞*
あいすそーど	アイスソード	名詞サ変*
あいすほっけー	アイスホッケー	名サ形動*
あいち	アイチ	名詞サ変$
あいつ	アイツ	名詞サ変*
あいてみ	相手見	一段動詞$
あいてむ	アイテム	名詞サ変*
あいぬ	アイヌ	名詞サ変$
あいばにーず	アイバニーズ	名詞サ変$
あいびーず	アイビーズ	名サ形動*
あいます	アイマス	名詞サ変*
あいますく	アイマスク	名詞サ変$
あいらーう゛ぁた	アイラーヴァタ	名詞サ変*
あいん	アイン	名詞サ変*
あう	アウ	名サ形動*
あうぇー	アウェー	名詞サ変*
あうぇい	アウェイ	名詞サ変*
あう゛ぇ	アヴェ	名詞サ変$
あか	ァカ	名サ形動*
あかいと	赤糸	名詞*
あかぎ	アカギ	名サ形動*
あかぎ	アカギ	名詞サ変*
あかさん	赤さん	名詞*
あかです	アカデス	名サ形動*
あかどり	赤鳥	名詞*
あかま	紅馬	名詞*
あがす	ありがとうございます	名詞*
あがた	ありがとうございました	名詞*
あきほ	明保	固有人名$
あきほ	明?	固有人名$
あきほ	明穗	固有人名$
あきら	アキラ	名サ形動*
あきらめてみ	諦めて見	一段動詞*
あきれす	アキレス	名詞サ変*
あぎだいん	アギダイン	名詞サ変*
あぎと	アギト	名詞サ変*
あぎらお	アギラオ	名詞サ変*
あく	アク	名詞サ変*
あくあんず	アクアンズ	名詞サ変*
あくしーど	アクシード	名詞サ変$
あくす	アクス	名詞サ変*
あくせら	アクセラ	名詞サ変*
あくせる	アクセル	名詞サ変*
あくなー	アクナー	名サ形動*
あくりょくけい	握力系	名詞*
あくろ	アクロ	名詞サ変*
あぐっれっしぶさ	アグッレッシブサ	名サ形動*
あぐりー	アグリー	名詞サ変*
あぐりあす	アグリアス	名詞サ変*
あけ	アケ	名詞サ変*
あけてるとき	あけてる時	名詞*
あげるべき	上げるべき	名詞形動$
あげるわけ	あげる訳	名詞*
あご	アゴ	名サ形動*
あご	アゴ	名詞サ変$
あごう゛ぃでお	アゴヴィデオ	名サ形動*
あごの	アゴノ	名サ形動*
あごん	阿含	固有人姓$
あごん	阿厳	名詞*
あさくり	アサクリ	名詞サ変*
あさしんずくりーど	アサシンズクリード	名詞サ変$
あさりさん	あさりさん	接尾語*
あざぜる	アザゼル	名詞サ変*
あざとーす	アザトース	名詞サ変$
あしぇらと	アシェラト	名詞サ変*
あしゅら	アシュラ	名詞サ変*
あしたか	アシタカ	名サ形動*
あじゃすたー	アジャスター	名サ形動*
あじっこ	味っ子	名詞*
あじと	アジト	名詞サ変$
あす	アス	名サ形動*
あす１	ありがとうございます	名詞*
あすか	アスカ	名サ形動*
あすたるて	アスタルテ	名詞サ変*
あすてあ	アステア	名詞サ変*
あすら	アスラ	名詞サ変*
あずま	アズマ	名詞サ変*
あずみ	アズミ	名詞サ変*
あずらえる	アズラエル	名詞サ変*
あせんしょん	アセンション	名詞サ変$
あた	あた	名詞サ変*
あた	ありがとうございました	名詞*
あた	亜他	名詞*
あたっくむーぶ	アタックムーブ	名サ形動*
あたえたわけ	与えた訳	名詞$
あたえること	与える事	名詞$
あたのーる	アタノール	名詞サ変*
あたらしいこと	新しい事	名詞*
あたりでき	当たり出来	一段動詞$
あだち	あだち	名詞*
あだむ	アダム	名詞サ変$
あちぇり	アチェリ	名詞サ変*
あちゃー	アチャー	名詞サ変*
あつ	アツ	名詞サ変*
あつぅぃ	アツゥィ	名詞サ変*
あつぅい	アツゥイ	名詞サ変$
あついね	アツイネ	名サ形動*
あつかってるわけ	扱ってる訳	名詞*
あつかうこと	扱う事	名詞*
あつまるところ	集まる所	名詞$
あつや	アツヤ	名詞サ変$
あつろう	アツロウ	名詞サ変*
あて	アテ	名サ形動*
あて	亜手	名詞*
あて	アテ	名詞サ変$
あてぃす	アティス	名詞サ変*
あとすみふ	アトスミフ	名詞サ変*
あとらす	アトラス	名詞サ変*
あとろぽす	アトロポス	名詞サ変*
あどおん	アドオン	名詞サ変*
あどり	アドリ	名サ形動*
あどん	アドン	名詞サ変$
あな	アナ	名サ形動*
あな	アナ	名詞サ変$
あなきん	アナキン	名サ形動*
あなたのはだがすき	アナタノハダガスキ	名詞サ変*
あなたはだがすきだからー	アナタハダガスキダカラー	名詞サ変*
あなる	アナル	名サ形動*
あなる	アナル	名詞サ変*
あなんた	アナンタ	名詞サ変*
あに	アニ	名詞サ変$
あにーた	アニータ	名詞サ変*
あにおた	アニオタ	名詞サ変$
あにき	アニキ	名詞サ変*
あにそん	アニソン	名サ形動*
あにま	アニマ	名詞サ変*
あにめ	アニメ	名詞サ変*
あぬびす	アヌビス	名詞サ変*
あぬらす	アヌラス	名サ形動*
あねは	アネハ	名サ形動*
あのーるろんど	アノールロンド	名詞サ変$
あのおと	あの音	名詞*
あばどん	アバドン	名詞サ変*
あばれまくり	アバレマクリ	名詞サ変*
あばれる	アバレル	名詞サ変*
あび	阿尾	固有人姓$
あびじごく	阿鼻地獄	名詞*
あぴす	アピス	名詞サ変*
あふれ	アフレ	名詞サ変$
あふれこ	アフレ湖	名詞$
あぶ	アブ	名詞サ変$
あぶな	アブナ	名サ形動*
あぶない	ｱﾌﾞﾅｲ	名詞*
あぶない	アブナイ	名サ形動*
あぶないしそう	危ない思想	名詞*
あぷさらす	アプサラス	名詞サ変*
あへ	アヘ	名サ形動*
あべ	アベ	名詞サ変*
あほ	アホ	名サ形動*
あほ	アホ	名詞サ変*
あほか	アホカ	名サ形動*
あほす	アホス	名サ形動*
あぽろん	アポロン	名詞サ変*
あま	アマ	名詞サ変*
あまぁい	アマァイ	名詞サ変*
あまじゃけ	天鮭	名詞$
あまだ	アマダ	名詞サ変*
あまちゅあ	アマチュア	名詞サ変*
あまてらす	アマテラス	名詞サ変*
あまでうす	アマデウス	名詞サ変*
あまね	アマネ	名詞サ変*
あまねねら	アマネネラ	名詞サ変*
あまり	アマリ	名サ形動*
あみば	アミバ	名詞サ変$
あむりた	アムリタ	名詞サ変*
あむろ	アムロ	名サ形動*
あむろ	アムロ	名詞サ変$
あめ	アメ	名サ形動*
あめ	亜眼	名詞*
あめ	アメ	名詞サ変$
あめこう	アメ公	名詞*
あめこみ	アメコミ	名サ形動*
あめのうずめ	アメノウズメ	名詞サ変*
あめのふとたま	アメノフトタマ	名詞サ変*
あめふとｐ	アメフトｐ	名詞*
あめふとぉ	アメフトォ	名詞サ変*
あめりか	アメリカ	名詞サ変*
あめりかは	アメリカハ	名サ形動*
あめりかより	アメリカ寄り	名詞$
あゆは	アユハ	名詞サ変*
あらい	アライ	名詞サ変$
あらた	アラタ	名詞サ変$
あらはばき	アラハバキ	名詞サ変*
あらびあご	アラビアご	接頭語*
あらみさき	アラミサキ	名詞サ変*
あらみたま	アラミタマ	名詞サ変*
あり	アリ	名詞サ変*
ありう	アリ宇	名詞*
ありえないこと	あり得ない事	名詞$
ありか	アリカ	名詞サ変$
ありがたいこと	ありがたい事	名詞$
ありげーた	アリゲータ	名詞サ変*
ありげーたまんと	アリゲータマント	名詞サ変*
ありす	アリス	名詞サ変*
ありへん	蟻編	名詞$
ありまｒ	アリマｒ	名詞*
ありまり	アリマリ	名サ形動*
ありも	アリモ	名詞サ変*
ある	アル	名詞サ変*
あるかな	アルカナ	名詞サ変*
あるかん	アルカン	名詞サ変$
あるけにー	アルケニー	名詞サ変*
あるけみすと	アルケミスト	名詞サ変*
あるしゃだい	アルシャダイ	名詞サ変*
あるしんどになちゃうよー	ｱﾙｼﾝﾄﾞﾆﾅﾁｬｳﾖｰ	名詞サ変$
あるてぃまにあ	アルティマニア	名詞サ変$
あるてみしあ	アルテミシア	名詞サ変*
あるのると	アルノルト	名詞サ変$
あるばむ	アルバム	名詞サ変*
あるばれすと	アルバレスト	名詞サ変*
あるふぁべっと	アルファベット	名詞サ変*
あるぺじお	アルペジオ	名詞サ変$
あるみん	アルミン	名詞サ変$
あるめせら	アルメセラ	名詞サ変*
あるらうね	アルラウネ	名詞サ変*
あるるーな	アルルーナ	名詞サ変*
あるろふすきー	アルロフスキー	名詞サ変*
あれ	あるぇー(・３・)	名詞*
あれ	アレ	名サ形動*
あれ	アレ	名詞サ変$
あれっしゃんどれ	アレッシャンドレ	名サ形動*
あれきさんだー	アレキサンダー	名詞サ変*
あれす	アレス	名詞サ変*
あれれ	アレレ	名サ形動*
あろーれいん	アローレイン	名詞サ変*
あろんあるふぁ	アロンアルファ	名サ形動*
あわ	亜話	名詞*
あん	アン	名詞サ変*
あんっ	ｱﾝｯ	名詞サ変$
あんあん	アンアン	名詞サ変*
あんぐら	アングラ	名詞サ変*
あんこー	アンコー	名詞サ変*
あんこーるわっと	アンコールワット	名詞サ変*
あんごうぶん	暗号分	名詞*
あんさいくろぺでぃあ	アンサイクロペディア	名サ形動*
あんじぇりーな	アンジェリーナ	名サ形動*
あんじょ	安所	名詞*
あんずー	アンズー	名詞サ変*
あんち	アンチ	名詞サ変*
あんちうぃるす	アンチウィルス	名詞サ変*
あんちえいりあす	アンチエイリアス	名詞サ変*
あんと	アント	名詞サ変*
あんとりあ	アントリア	名詞サ変*
あんどらす	アンドラス	名詞サ変$
あんな	アンナ	名詞サ変$
あんぷろしあ	アンプロシア	名詞サ変*
あんらくしでき	安楽死出来	一段動詞*
あんろっく	アンロック	名詞サ変*
いっ	イッ	名詞サ変*
いっき	イッキ	名詞サ変$
いっききゅん	イッキキュン	名詞サ変$
いっしょく	1色	名詞*
いっしょく	1食	名詞*
いった	イッタ	名詞サ変$
いったく	一択	名詞*
いってみせ	言って見せ	一段動詞$
いってるとき	いってる時	名詞*
いってん	言ってん	名詞*
いってんじゃ	言ってんじゃ	名詞*
いってんの	いってんの	名詞サ変*
いっぱんじん	一般陣	名詞*
いっぽんだたら	イッポンダタラ	名詞サ変*
いーのっくのかたきをとるのです	ｲｰﾉｯｸﾉｶﾀｷｦﾄﾙﾉﾃﾞｽ	名詞サ変*
いい	イイ	名詞サ変*
いいところ	良い所	名詞$
いいはなしだなー	ｲｲﾊﾅｼﾀﾞﾅｰ	名詞サ変*
いいわけ	イイワケ	名サ形動*
いうこと	言うこと	名詞*
いうことじ	言子徒事	名詞*
いうことじゃ	言子徒事ゃ	名詞サ変*
いうところから	言うところ空	名詞$
いうのがよ	言うのが良	形容詞*
いう゛	イヴ	名詞サ変$
いえ	イエ	名サ形動*
いえねぇ	言えねぇ	名詞サ変*
いおん	イオン	名詞サ変$
いか	イカ	名詞サ変*
いかい	異界	名詞*
いかさま	イカサマ	名詞サ変*
いかつい	イカツイ	名詞サ変*
いかないだろう	いかないだろう	感動詞*
いかにて	いかに手	名詞*
いかれた	イカレタ	名サ形動*
いかん	イカン	名詞サ変*
いがいのこと	以外の事	接尾語*
いがいのこと	以外の事	名詞*
いき	イキ	名詞サ変*
いきいき	イキイキ	名詞サ変*
いきがお	イキ顔	名詞サ変*
いきすぎ	イキ過ぎ	名詞*
いきすぎぃ	イキスギィ	名詞サ変$
いきていけ	生きて行け	一段動詞$
いきてりゃ	イキテリャ	名サ形動*
いきてりゃ	いきてりゃ	名詞*
いきること	生きる事	名詞*
いぎりす	イギリス	名詞サ変*
いく	イク	名詞サ変*
いく	行	固有人名$
いくいくいく	ｲｸｲｸｲｸ	名詞サ変$
いくすきゅーしょなー	イクスキューショナー	名詞サ変*
いくらかね	いくら金	名詞$
いぐぅー	イグゥー	名サ形動*
いぐどらしる	イグドラシル	名詞サ変*
いぐどらじる	イグドラジル	名詞サ変*
いけ	イケ	名詞サ変*
いけてる	イケテル	名サ形動*
いけないところ	いけないところ	名詞$
いけめん	イケメン	名サ形動*
いけめん	イケメン	名詞サ変*
いけよ	生けよ	名詞*
いける	イケル	名詞サ変$
いけんとしてみ	意見として見	一段動詞$
いこーる	イコール	名詞サ変*
いご	イゴ	名詞サ変*
いごーる	イゴール	名サ形動*
いざなぎ	イザナギ	名詞サ変$
いざなみ	イザナミ	名詞サ変$
いしずえ	イシズエ	名詞サ変$
いしば	石刃	名詞$
いしむら	イシムラ	名詞サ変*
いじりー	イジリー	名サ形動*
いすらふぃーる	イスラフィール	名詞サ変*
いすらむきょう	イスラムキョウ	名詞サ変*
いずし	いずし	名詞サ変*
いずし	飯寿司	名詞*
いそいでみ	急いで見	一段動詞*
いたい	イタイ	名サ形動*
いたたた	イタタタ	名詞サ変*
いたたたたたた	イタタタタタタ	名サ形動*
いたち	イタチ	名詞サ変*
いたまえ	イタマエ	名詞サ変*
いたら	イタラ	名サ形動*
いたり	イタリ	名サ形動*
いたりっく	イタリック	名詞サ変*
いたりー	イタリー	名サ形動*
いたりあ	イタリア	名詞サ変*
いたりあは	イタリアハ	名詞サ変*
いたりあん	イタリアン	名詞サ変*
いち	いち	名詞*
いちゃ	イチャ	名詞サ変*
いちゃいちゃ	イチャイチャ	名サ形動*
いちゃいちゃ	イチャイチャ	名詞サ変*
いちょう	イチョウ	名詞サ変*
いちの	一乃	名詞$
いちは	Ⅰ葉	名詞*
いちまい	1枚	名詞*
いちもくりょうぜん	一目霊山	固有地名*
いちもつ	イチモツ	名詞サ変*
いちろー	イチロー	名詞サ変*
いちわ	いちわ	名詞サ変*
いちわ	一話	名詞*
いちわにして	いちわ西手	固有人姓*
いつかてんまのくろうさぎぃ	ｲﾂｶﾃﾝﾏﾉｸﾛｳｻｷﾞｨ	名詞サ変$
いつまで	イツマデ	名詞サ変*
いとけん	イトケン	名詞サ変*
いないれ	イナイレ	名詞サ変*
いなくろ	イナクロ	名詞サ変$
いなずま	イナズマ	名詞サ変*
いなずまがた	イナズマ型	名詞*
いなだん	イナダン	名詞サ変$
いなに	い何	副詞*
いなばしろうさぎ	イナバシロウサギ	名詞サ変*
いなばの	イナバノ	名詞サ変*
いに	イニ	名詞サ変$
いぬーぴー	イヌーピー	名詞サ変*
いぬかみ	イヌカミ	名詞サ変*
いねい	稲胃	名詞*
いねい	稲い	一段動詞*
いねいね	稲稲	名詞*
いねいね	稲い根	名詞*
いぱｄ	ｉｐａｄ	名詞サ変$
いぱーらいふる	イパーライフル	名サ形動*
いびる	イビル	名詞サ変*
いぶら	イブラ	名詞サ変*
いべ	イベ	名詞サ変$
いまいち	イマイチ	名サ形動*
いまいち	イマイチ	名詞サ変$
いまど	今ど	カ行五段*
いまん	イマン	名詞サ変*
いみのな	意味の無	形容詞*
いめー	イメー	名サ形動*
いめーじでき	イメージ出来	一段動詞*
いや	イヤ	名サ形動*
いや	イヤ	名詞サ変*
いらすた	イラスタ	名詞サ変$
いらすと	イラスト	名詞サ変*
いらね	イラネ	名サ形動*
いらね	いらね	名詞サ変*
いらね	イラネ	名詞サ変*
いるみ	イルミ	名サ形動*
いるみなてぃ	イルミナティ	名詞サ変$
いれ	イレ	名サ形動*
いれいざーへっど	イレイザーヘッド	名サ形動*
いれぶん	イレブン	名詞サ変$
いろかね	色金	名詞*
いろもの	イロモノ	名詞サ変$
いろもん	イロモン	名サ形動*
いわ	以和	名詞*
いわぉろ	イワォロ	名詞サ変*
いわっち	イワッチ	名詞サ変$
いわお	イワオ	名サ形動*
いわな	イワナ	名詞サ変$
いわみゅーら	イワミューラ	名詞サ変*
いわむ	イワム	名サ形動*
いわれたとおり	言われた通り	名詞$
いん・・	イン・・	名詞サ変*
いんえい	胤栄	名詞*
いんか	インカ	名詞サ変*
いんきゅばす	インキュバス	名詞サ変*
いんぎ	いんぎ	名詞サ変*
いんくり	インクリ	名詞サ変*
いんざーぎ	インザーギ	名サ形動*
いんしゅん	胤舜	名詞*
いんすます	インスマス	名詞サ変$
いんたーれーす	インターレース	名サ形動*
いんて	インテ	名詞サ変*
いんてぃ	インティ	名詞サ変*
いんていり	インテイリ	名サ形動*
いんてり	インテリ	名詞サ変*
いんでっくす	インデックス	名詞サ変*
いんど	インド	名詞サ変*
いんふぁなる	インファナル	名サ形動*
いんふぇるの	インフェルノ	名詞サ変*
いんむ	いんむ	名詞*
いんむ	淫夢	名詞*
いんむらんど	インムランド	名詞サ変*
いんらいん	インライン	名詞サ変*
いんりん	インリン	名詞サ変*
うぃっ	ウィッ	名サ形動*
うぃっち	ウィッチ	名詞サ変*
うぃっぷ	ウィップ	名詞サ変*
うぃー	ウィー	名サ形動*
うぃー	ウィー	名詞サ変$
うぃーうぃー	ウィーウィー	名詞サ変*
うぃーる	ウィール	名サ形動*
うぃき	ウィキ	名サ形動*
うぃざーずはーもにー	ウィザーズハーモニー	名サ形動*
うぃざーどりぃ	ウィザードリィ	名詞サ変*
うぃにんぐぽすと	ウィニングポスト	名サ形動*
うぃひ	ウィヒ	名詞サ変*
うぃるす	ウィルス	名詞サ変*
うぃん	ウィン	名詞サ変*
うぃんどぶれす	ウィンドブレス	名詞サ変*
うぇーうぇー	ウェーウェー	名詞サ変*
うぇーる	ウェール	名詞サ変*
うぇーるず	ウェールズ	名詞サ変*
うぇあっ	ウェアッ	名詞サ変$
うぇい	ウェイ	名詞サ変*
うぇいと	ウェイト	名詞サ変*
うぇえ	ウェエ	名サ形動*
うぇえええ	ウェエエエ	名サ形動*
うぇすかー	ウェスカー	名詞サ変*
うぇはーす	ウェハース	名詞サ変*
うぇみ	ｳｪﾐ	名詞サ変$
うぇみだー	ｳｪﾐﾀﾞｰ	名詞サ変$
うぇんでぃご	ウェンディゴ	名詞サ変*
うぉ	フー	名サ形動$
うぉー	ウォー	名詞サ変*
うぉーくらい	ウォークライ	名詞サ変*
うぉーず	ウォーズ	名詞サ変*
うぉーたーえるふ	ウォーターエルフ	名詞サ変*
うぉーほる	ウォーホル	名詞サ変$
うぉーりー	ウォーリー	名詞サ変*
うぉーりあー	ウォーリアー	名サ形動*
うぉう	ウォウ	名詞サ変$
うぉううぉう	ウォウウォウ	名詞サ変$
うぉるこっと	ウォルコット	名詞サ変$
うっず	ウッズ	名詞サ変$
うっちー	ウッチー	名詞サ変*
うってるとき	打ってる時	名詞*
うーず	ウーズ	名詞サ変*
うーまん	ウーマン	名詞サ変*
ういいれ	ウイイレ	名サ形動*
ういていること	浮いている事	名詞$
うう	ウウ	名サ形動*
うう	宇宇	名詞*
うえ	↑	名詞*
うえはら	ウエハラ	名詞サ変$
うえるかむはうす	ウエルカムハウス	名サ形動*
うぎ	ウギ	名詞サ変*
うけ	ウケ	名サ形動*
うけてる	ウケテル	名サ形動*
うける	ウケル	名サ形動*
うける	ウケル	名詞サ変*
うけるん	ウケルン	名詞サ変*
うこばく	ウコバク	名詞サ変$
うさいん	ウサイン	名サ形動*
うざ	ウザ	名詞サ変*
うざい	ウザイ	名詞サ変*
うざきゃら	ウザキャラ	名詞サ変*
うすかわ	薄革	名詞*
うすがわ	薄革	名詞*
うそ	ウソ	名詞サ変*
うたますたりー	ウタマスタリー	名詞サ変*
うたますたりー	歌マスタリー	名詞サ変*
うちの	ウチノ	名サ形動*
うてきて	ウテキテ	名詞サ変*
うてんの	うてんの	名詞*
うではね	腕羽	名詞*
うばやま	姥山	名詞$
うぶぬし	うぶ主	名詞*
うぷ	ウプ	名詞サ変*
うぷ	うぷ	名詞サ変*
うぷぬし	うぷ主	名詞*
うほっ	ウホッ	名詞サ変*
うまければい	美味ければ良	形容詞*
うみだすこと	生み出す事	名詞*
うめ	ウメ	名詞サ変*
うめぇててて	うめぇｗｗｗ	名詞*
うめず	楳図	名詞*
うめずかずお	楳図かずお	名詞*
うめづ	うめづ	名詞サ変*
うめはら	ウメハラ	名サ形動*
うめはら	ウメハラ	名詞サ変*
うよく	ウヨク	名詞サ変*
うら	ウラ	名詞サ変$
うらき	ウラキ	名詞サ変*
うらやましいよ	うらやましい酔	ワ行五段$
うりつけられてる	売りつけられてル	感動詞$
うるう゛ぁりん	ウルヴァリン	名サ形動*
うるう゛ぁりん	ウルヴァリン	名詞サ変*
うるびだ	ウルビダ	名詞サ変$
うるみん	ウルミン	名サ形動*
うろこ	ウロコ	名詞サ変*
うろぶち	ウロブチ	名詞サ変$
うろぼろす	ウロボロス	名詞サ変*
うわ	うわなにをするやめｑａｗｓｅｄｒｆｔｙ	名詞*
うん	ウン	名詞サ変*
うんこたとぅー	ウンコタトゥー	名詞サ変$
うんし	ウンシ	名サ形動*
うんし	運指	名詞*
うんでぃーね	ウンディーネ	名詞サ変*
うんでぃね	ウンディネ	名詞サ変*
う゛	ヴ	名詞サ変*
う゛ぁ	ヴァ	名詞サ変*
う゛ぁ	う゛ぁ	名詞サ変*
う゛ぁーちゃ	ヴァーチャ	名詞サ変*
う゛ぁーちゃー	ヴァーチャー	名詞サ変*
う゛ぁーな	ヴァーナ	名詞サ変*
う゛ぁいおりん	ヴァイオリン	名詞サ変*
う゛ぁいす	ヴァイス	名サ形動*
う゛ぁるきりー	ヴァルキリー	名詞サ変*
う゛ぁん	ヴァン	名詞サ変*
う゛ぁんげりす	ヴァンゲリス	名詞サ変*
う゛ぁんぱいあ	ヴァンパイア	名詞サ変*
う゛ぃ	ヴィ	名詞サ変*
う゛ぃ	う゛ぃ	名詞サ変*
う゛ぃっと	ヴィット	名サ形動*
う゛ぃーう゛る	ヴィーヴル	名詞サ変*
う゛ぃーぐる	ヴィーグル	名サ形動*
う゛ぃう゛ぃあん	ヴィヴィアン	名詞サ変*
う゛ぃえら	ヴィエラ	名サ形動*
う゛ぃえり	ヴィエリ	名サ形動*
う゛ぃくたー	ヴィクター	名詞サ変*
う゛ぃしゅぬ	ヴィシュヌ	名詞サ変*
う゛ぃじ	ヴィジ	名詞サ変*
う゛ぃじゅ	ヴィジュ	名サ形動*
う゛ぃじゅある	ヴィジュアル	名詞サ変*
う゛ぃた	ヴィタ	名詞サ変$
う゛ぃた	ｖｉｔａ	名詞サ変$
う゛ぃち	ヴィチ	名詞サ変$
う゛ぃるへるみな	ヴィルヘルミナ	名詞サ変$
う゛ぃん	ヴィン	名サ形動*
う゛ぇ	ヴェ	名詞サ変*
う゛ぇー	ヴェー	名詞サ変*
う゛ぇーたら	ヴェータラ	名詞サ変*
う゛ぇーる	ヴェール	名詞サ変*
う゛ぇる	ヴェル	名サ形動*
う゛ぇるせす	ヴェルセス	名詞サ変$
う゛ぇるたーす	ヴェルタース	名サ形動*
う゛ぉ	ヴォ	名詞サ変*
う゛ぉー	ｳﾞｫｰ	名詞サ変$
う゛ぉー・・・	ｳﾞｫｰ･･･	名詞サ変$
う゛ぉーかえろいど	ヴォーカエロイド	名詞サ変*
う゛ぉーかろいど	ヴォーカロイド	名詞サ変$
う゛ぉーかろいど	ｳﾞｫｰカロイド	名詞サ変$
う゛ぉーすげー	ｳﾞｫｰｽｹﾞｰ	名詞サ変$
う゛ぉかろ	ヴォカロ	名詞サ変$
う゛ぉじゃのーい	ヴォジャノーイ	名詞サ変*
う゛ぉんでーじ	ヴォンデージ	名詞サ変*
う゛う゛う゛	ヴヴヴ	名詞サ変$
えｄ	エド	名サ形動$
えｔｃ	Ｅｔｃ	名詞サ変$
えぅーご	エゥーゴ	名サ形動*
えっふぇる	エッフェル	名詞サ変*
えっふぇるとう	エッフェル党	名詞*
えーす	エース	名詞サ変*
えあ	エア	名詞サ変*
えあーまん	エアーマン	名サ形動*
えあこり	エアコリ	名サ形動*
えあもと	エア元	名詞*
えあもと	エアモト	名詞サ変$
えあらんどばとる	エアランドバトル	名サ形動*
えあろす	エアロス	名詞サ変*
えいが	鋭牙	名詞*
えいし	鋭歯	名詞*
えいじ	英辞	名詞サ変*
えいじろう	英辞郎	名詞*
えいなむ	エイナム	名詞サ変$
えいふぇっくすついん	エイフェックスツイン	名詞サ変$
えいべっくそ	エイベックソ	名詞サ変*
えいみんぐ	エイミング	名詞サ変*
えいりあ	エイリア	名詞サ変$
えいりあす	エイリアス	名詞サ変*
えうれか	エウレカ	名詞サ変$
えう゛ぁ	エヴァ	名詞サ変*
えう゛ぁも	エヴァモ	名詞サ変*
えう゛りでい	エヴリデイ	名サ形動*
えがけるわけ	描ける訳	名詞$
えきせい	液性	接尾語$
えきせい	液性	名詞$
えくざいる	エクザイル	名詞サ変$
えくしりあ	エクシリア	名詞サ変$
えくす	エクス	名詞サ変$
えくすたし	エクスタシ	名詞サ変*
えくすたしー	エクスタシー	名詞サ変*
えくすぷろーら	エクスプローラ	名詞サ変*
えくすぺりめんたる	エクスペリメンタル	名詞サ変*
えくせる	エクセル	名詞サ変*
えぐ	エグ	名詞サ変$
えぐい	エグイ	名詞サ変*
えぐぜくたー	エグゼクター	名サ形動*
えこえこあざらく	エコエコアザラク	名サ形動*
えこらて	エコラテ	名詞サ変$
えせ	エセ	名サ形動*
えぜきえる	エゼキエル	名詞サ変*
えたーなる	エターナル	名詞サ変$
えちん	エチン	名詞サ変$
えでぃた	エディタ	名詞サ変*
えど	エド	名詞サ変*
えど・はりす	エド・ハリス	名サ形動*
えどがわ	エドガワ	名詞サ変$
えなし	絵なし	名詞*
えなじーどれいん	エナジードレイン	名詞サ変*
えに	ｴﾆ	名詞サ変$
えにしんぐ	ｴﾆｼﾝｸﾞ	名詞サ変$
えのく	エノク	名詞サ変*
えびす	エビス	名詞サ変$
えびふりゃー	エビフリャー	名詞サ変*
えびむき	エビ剥き	名詞サ変*
えぴ	エピ	名詞サ変*
えぷそん	エプソン	名詞サ変*
えぼしっくす	エボシックス	名サ形動*
えま	エマ	名サ形動*
えみゅ	エミュ	名サ形動*
えみゅ	エミュ	名詞サ変*
えらごｎ	エラゴｎ	名詞サ変*
えり	エリ	名詞サ変$
えりっく	エリック	名詞サ変$
えりー	エリー	名詞サ変$
えりーと	エリート	名詞サ変*
えりあきゅあ	エリアキュア	名詞サ変*
えりごーる	エリゴール	名詞サ変$
えりごのみをやめるのです	ｴﾘｺﾞﾉﾐｦﾔﾒﾙﾉﾃﾞｽ	名詞サ変*
えりざべす	エリザベス	名詞サ変*
えりだぬす	エリダヌス	名詞サ変*
える	エル	名詞サ変*
える	ｴﾙ	名詞サ変*
えるう゛ぃす	エルヴィス	名詞サ変*
えるしゃだい	エルシャダイ	名詞サ変*
えるしゃだい	ｴﾙｼｬﾀﾞｲ	名詞サ変*
えるびす	エルビス	名詞サ変*
えるふぇん	エルフェン	名詞サ変*
えれ	エレ	名サ形動*
えれいん	エレイン	名サ形動*
えろ	エロ	名詞サ変*
えろい	エロイ	名詞サ変*
えろいーす	エロイース	名詞サ変$
えろげ	エロゲ	名サ形動*
えろげ	エロゲ	名詞サ変*
えろす	エロス	名詞サ変$
えろろっと	エロロット	名詞サ変$
えん	\	感動詞*
えんかうんと	エンカウント	名詞サ変*
えんこ	エンコ	名サ形動*
えんこう	援交	名詞*
えんさん	えんさん	名詞*
えんさんし	演算子	名詞*
えんざ	エンザ	名詞サ変*
えんしゃんと	エンシャント	名サ形動*
えんじぇる	エンジェル	名詞サ変*
えんじぇるろーぶ	エンジェルローブ	名詞サ変*
えんじにあ	エンジニア	名詞サ変*
えんぜるうぃんぐ	エンゼルウィング	名詞サ変*
えんたーていんめん	エンターテイン面	名詞*
えんつぉ	エンツォ	名サ形動*
えんどう	円堂	固有人姓$
えんま	エンマ	名詞サ変*
えんや	エンヤ	名詞サ変*
えんりっち	エンリッチ	名詞サ変*
おｍ	オーエム	名サ形動$
おぅ	オゥ	名詞サ変*
おぉん	オォン	名詞サ変$
おっされーているぅ	オッサレーテイルゥ	名詞サ変$
おっさん	オッサン	名詞サ変*
おっす	オッス	名詞サ変*
おっすおっす	オッスオッス	名詞サ変*
おっず	オッズ	名詞サ変*
おっぱい	オッパイ	名詞サ変*
おっぱいのぺらぺらそーす	ｵｯﾊﾟｲﾉﾍﾟﾗﾍﾟﾗｿｰｽ	名詞サ変*
おー	オー	名詞サ変*
おーかす	オーカス	名詞サ変*
おーが	オーガ	名サ形動*
おーじーは	オージーハ	名詞サ変*
おーすとら	オーストラ	名サ形動*
おーそどっくっす	オーソドックッス	名詞サ変$
おーそどっくす	オーソドックス	名詞サ変$
おーでぃん	オーディン	名詞サ変*
おーとしぇいぷ	オートシェイプ	名詞サ変*
おーねすと	オーネスト	名詞サ変$
おーば	オーバ	名詞サ変*
おーら	オーラ	名詞サ変*
おーるすたー	オールスター	名詞サ変*
おあしす	オアシス	名詞サ変*
おい	オイ	名詞サ変*
おいぃ	オイぃ	名詞サ変*
おいおい	オイオイ	名詞サ変*
おいおいよ	オイオイヨ	名詞サ変*
おいげん	オイゲン	名詞サ変$
おいしい	オイシイ	名サ形動*
おいよいよ	オイヨイヨ	名詞サ変*
おいる	オイル	名詞サ変*
おう	オウ	名詞サ変*
おうが	オウガ	名サ形動*
おうき	桜鬼	名詞$
おうむ	オウム	名詞サ変*
おうる	オウル	名詞サ変*
おえ	尾枝	名詞*
おお	御お	接頭語*
おおえ	大枝	名詞*
おおお	ｵｵｵ	名詞サ変$
おおかに	オオカニ	名詞サ変*
おおかま	大鎌	名詞*
おおかみ	オオカミ	名詞サ変$
おおざる	オオザル	名サ形動*
おおざる	大猿	名詞*
おおた	大田	名詞$
おおたち	大太刀	名詞$
おおつの	大角	固有人姓$
おおつのしか	大角鹿	名詞$
おおつのじか	オオツノジカ	名詞サ変$
おおづめ	大爪	名詞*
おおとりのはね	大鳥の羽	名詞*
おおなまけもの	オオナマケモノ	名詞サ変*
おおば	大刃	名詞*
おか	オカ	名詞サ変*
おかか	オカカ	名詞サ変$
おかかとー	ｵｶｶﾄｰ	名詞サ変$
おかさ	オカサ	名詞サ変$
おかしい	オカシイ	名詞サ変*
おかず	オカズ	名詞サ変*
おかま	オカマ	名詞サ変*
おかやまけんか	岡山県歌	名詞$
おかりな	オカリナ	名詞サ変*
おかん	オカン	名詞サ変$
おがた	オガタ	名サ形動*
おがま	おがま	名詞*
おきくむし	オキクムシ	名詞サ変*
おくたごん	オクタゴン	名サ形動*
おくたごん	オクタゴン	名詞サ変*
おくらせること	遅らせる事	名詞*
おくるため	送る為	名詞*
おぐん	オグン	名詞サ変*
おけつ	御ケツ	名詞サ変$
おされ	オサレ	名サ形動*
おされ	オサレ	名詞サ変*
おざわ	オザワ	名詞サ変*
おしゃれ	オシャレ	名詞サ変*
おしゃれそう	オシャレ層	名詞$
おす	オス	名詞サ変*
おすかーわいるど	オスカーワイルド	名サ形動*
おすすめ	オススメ	名サ形動*
おずめんと	オズメント	名サ形動*
おずわるど	オズワルド	名詞サ変$
おせ	オセ	名詞サ変*
おせろわーるど	オセロワールド	名サ形動*
おそくなったこと	遅くなった事	名詞$
おそれられてるわ	恐れられてる輪	名詞*
おた	オタ	名サ形動*
おた	オタ	名詞サ変*
おたく	オタク	名サ形動*
おたけび	オタケビ	名詞サ変*
おたこん	オタコン	名サ形動*
おたんこなす	オタンコナス	名サ形動*
おち	オチ	名サ形動*
おちんこ	オチンコ	名詞サ変$
おと	オト	名詞サ変*
おとぅーさん	オトゥーサン	名詞サ変*
おとこえき	男液	名詞*
おとこす	オトコス	名詞サ変$
おとこの	男の	名詞サ変*
おとこのこ	男の顧	名詞*
おとこのこ	男の娘	名詞*
おとすの	オトスノ	名サ形動*
おとな	オトナ	名詞サ変*
おな	オナ	名詞サ変*
おなに	オナニ	名サ形動*
おに	オニ	名詞サ変*
おにづか	鬼束	固有人姓$
おにやんま	オニヤンマ	名サ形動*
おね	おね	名詞サ変$
おねぇ	オネェ	名詞サ変$
おはな	御花	名詞$
おばか	オバカ	名サ形動*
おばさん	オバサン	名サ形動*
おばさん	オバサン	名詞サ変*
おばま	オバマ	名サ形動*
おばま	オバマ	名詞サ変*
おばり	尾針	名詞*
おばりよん	オバリヨン	名詞サ変$
おぱい	ォパイ	名サ形動*
おぱいが	オパイガ	名サ形動*
おびすて	オビステ	名サ形動*
おふろ	オフロ	名詞サ変*
おふわーるど	オフワールド	名サ形動*
おぶ	オブ	名詞サ変*
おぶり	オブリ	名詞サ変$
おべろん	オベロン	名詞サ変*
おぺら	オペラ	名詞サ変*
おほ	オホ	名詞サ変*
おまえ	オマエ	名サ形動*
おまえだ	オマエダ	名サ形動*
おまえなかの	お前中野	固有人姓*
おまえなかの	お前中野	固有地名*
おまえのこと	お前の事	名詞$
おまえら	オマエら	名詞*
おまけ	オマケ	名サ形動*
おめておとる	オメテオトル	名詞サ変*
おめとお	オメトオ	名詞サ変*
おもいかね	オモイカネ	名詞サ変$
おもうぇーない	ｵﾓｳｪｰﾅｲ	名詞サ変$
おもくそ	オモクソ	名詞サ変*
おもしろいだろ	面白いダロ	固有一般*
おもしろいだろ	面白いだろ	名詞サ変*
おもしろくでき	面白く出来	一段動詞*
おもた	オモタ	名サ形動*
おもわないこと	思わない事	名詞$
おもわないとき	思わないと気	名詞*
おもわれていたわけ	思われていた訳	名詞$
おや	オヤ	名詞サ変*
おやしり	オヤシリ	名サ形動*
おやしろｓま	オヤシロｓマ	名詞*
おやびん	オヤビン	名詞サ変$
おり	オリ	名詞サ変*
おりあす	オリアス	名詞サ変*
おりこ	オリコ	名詞サ変$
おりし	オリシ	名サ形動*
おりじん	オリジン	名詞サ変*
おりぬの	織り布	名詞$
おりんぴっく	オリンピック	名詞サ変$
おる	オル	名詞サ変$
おるぎあ	オルギア	名サ形動*
おるくす	オルクス	名詞サ変*
おるとぺでぃこ	オルトペディコ	名詞サ変$
おるとりっち	オルトリッチ	名詞サ変$
おるとろす	オルトロス	名詞サ変*
おるふぇうす	オルフェウス	名詞サ変$
おれ	オレ	名サ形動*
おれ	オレ	名詞サ変*
おれお	オレオ	名詞サ変*
おれこわくない	ｵﾚｺﾜｸﾅｲ	名詞*
おれさま	俺様	名詞*
おれんｊ	オレンｊ	名詞*
おろち	オロチ	名詞サ変$
おろばす	オロバス	名詞サ変$
おわー	ｵﾜｰ	名詞サ変*
おわこん	オワコン	名詞サ変$
おわた	オワタ	名詞サ変*
おわらせる	終わらせ留	名詞*
おわんね	終わんね	名詞*
おん	ｵﾝ	名詞サ変$
おんぎょうき	オンギョウキ	名詞サ変*
おんだい	おんだい	名詞サ変*
おんだい	御大	名詞*
おんどぅる	オンドゥル	名詞サ変*
おんなのこ	女鋸	名詞*
おんもらき	オンモラキ	名詞サ変*
か	跏	名詞*
かっこ	カッコ	名詞サ変$
かっこいいかし	格好いい歌詞	名詞*
かっせん	活泉	名詞*
かったん	勝ったん	名詞*
かってるとき	勝ってる時	名詞*
かっぶぬー	カッブヌー	名詞サ変$
かー	かー	名詞サ変*
かー	カー	名詞サ変*
かーしー	カーシー	名詞サ変$
かーでっくす	カーデックス	名詞サ変*
かーねる	カーネル	名詞サ変*
かーびぃ	カービィ	名詞サ変*
かーぼーい	カーボーイ	名サ形動*
かーま	カーマ	名詞サ変*
かーますーとら	カーマスートラ	名詞サ変*
かーれーす	カーレース	名詞サ変*
かーん	カーン	名詞サ変*
かい	カイ	名サ形動*
かいえん	カイエン	名詞サ変$
かいこちゅう	懐古中	名詞$
かいご	かいご	名詞*
かいざー	カイザー	名詞サ変*
かいしょ	怪書	名詞サ変*
かいじ	カイジ	名サ形動*
かいじ	カイジ	名詞サ変$
かいすんだい	回駿台	固有組織$
かいたこと	書いた事	名詞$
かいち	カイチ	名詞サ変$
かいてること	描いてる事	名詞$
かいとす	カイトス	名詞サ変$
かいどー	カイドー	名詞サ変*
かいな	腕	単漢字$
かいばらゆうざん	海原雄山	名詞*
かいめいじゅう	カイメイジュウ	名詞サ変*
かいりょうでき	改良出来	一段動詞*
かいん	カイン	名詞サ変*
かう	カウ	名詞サ変*
かえっていか	帰って活か	サ行五段*
かえせぬ	返せ！	名詞*
かえぬ	買え！	名詞*
かえるわけ	帰る訳	名詞*
かえれ	カエレ	名サ形動*
かおう	華王	名詞*
かおす	カオス	名詞サ変*
かおてぃっく	カオティック	名詞サ変$
かおなし	カオナシ	名詞サ変$
かおのこと	顔の事	名詞*
かおる	カオル	名詞サ変*
かか	カカ	名詞サ変$
かかくこむでちぇっくするのです	ｶｶｸｺﾑﾃﾞﾁｪｯｸｽﾙﾉﾃﾞｽ	名詞サ変*
かがみやま	カガミヤマ	名詞サ変$
かがわ	カガワ	名詞サ変$
かぎ	カギ	名詞サ変*
かぎつめ	カギ爪	名詞*
かぎづめ	カギ爪	名詞*
かくえん	カクエン	名詞サ変*
かくかく	カクカク	名詞サ変*
かくご	角ゴ	名詞サ変$
かくてき	カクテキ	名詞サ変*
かくりょう	描く量	名詞*
かくりょう	カクリョウ	名詞サ変$
かけお	掛けお	接頭語*
かけら	カケラ	名詞サ変*
かけられていく	かけられてイク	名詞サ変*
かけりん	カケリン	名詞サ変$
かける	カケル	名詞サ変$
かけること	かける事	名詞$
かげろう	カゲロウ	名詞サ変$
かこもん	かこもん	名詞サ変$
かしゅぱぱ	カシュパパ	名詞サ変$
かしお	歌詞男	名詞*
かじゃ	カジャ	名サ形動*
かじゃ	カジャ	名詞サ変*
かじの	カジノ	名詞サ変$
かす	カス	名詞サ変*
かすかす	カスカス	名サ形動*
かすたむ	カスタム	名詞サ変*
かすとお	カストオ	名サ形動*
かすとらーと	カストラート	名詞サ変*
かすとらーど	カストラード	名サ形動*
かすとろ	カストロ	名詞サ変*
かず	カズ	名詞サ変$
かずひと	カズヒト	名詞サ変*
かずふぇる	カズフェル	名詞サ変*
かずや	カズヤ	名サ形動*
かずや	カズヤ	名詞サ変*
かずろー	カズロー	名詞サ変$
かせぐこと	稼ぐ事	名詞$
かぜに	風に	名詞*
かそ	カソ	名詞サ変*
かたーじゅ	カタージュ	名サ形動*
かたいし	堅石	名詞*
かたかな	かたかな	名詞サ変*
かたかな	カタカナ	名詞サ変*
かたきらうわ	カタキラウワ	名詞サ変*
かたぎ	カタギ	名サ形動*
かたぎ	堅木	名詞*
かたぎ	カタギ	名詞サ変$
かたこと	カタコト	名詞サ変$
かたし	方し	サ変動詞*
かたすとろふ	カタストロフ	名詞サ変*
かちょかばろ	カチョカバロ	名詞サ変$
かちょばっろ	カチョバッロ	名サ形動*
かちぐみ	カチグミ	名詞サ変$
かつお	カツオ	名詞サ変$
かつかれー	カツカレー	名詞サ変$
かつじ	カツジ	名詞サ変*
かつせん	活泉	名詞*
かつぜつ	滑舌	名詞*
かてじな	カテジナ	名詞サ変$
かてるわけ	勝てる訳	名詞*
かてんか	勝てんか	名詞*
かてんだろ	勝てんだろ	名詞サ変*
かとと	カトト	名詞サ変*
かとぷれぱす	カトプレパス	名詞サ変*
かなと	カナト	名詞サ変*
かねかね	金金	名詞$
かねき	かねき	名詞*
かねだ	金出	サ行五段*
かねつか	金使	ワ行五段*
かねない	金内	名詞$
かねはら	金払	ワ行五段$
かのうか	可能化	名詞サ変*
かはく	カハク	名詞サ変*
かばちゃん	カバチャン	名サ形動*
かばでぃーる	カバディール	名詞サ変$
かぶと	カブト	名サ形動*
かぶと	カブト	名詞サ変*
かぶとぼーぐ	カブトボーグ	名サ形動*
かぶとぼーぐ	カブトボーグ	名詞サ変*
かぷらかん	カプラカン	名詞サ変*
かへんちょう	可変超	接頭語*
かべがみ	かべがみ	名詞サ変$
かべの	かべの	名詞*
かま	カマ	名詞サ変$
かまくら	カマクラ	名サ形動*
かまそっそ	カマソッソ	名詞サ変*
かまぷああ	カマプアア	名詞サ変*
かまんべーさ	カマンベーサ	名詞サ変*
かみ	カミ	名詞サ変*
かみーゆ	カミーユ	名サ形動*
かみかみ	カミカミ	名詞サ変*
かみかみ	噛み噛み	名詞*
かみつしま	神津島	固有人姓$
かみつしま	神津島	固有地名$
かめら	カメラ	名詞サ変*
かも	カモ	名詞サ変$
かもーん	カモーン	名詞サ変*
かやのそと	カヤノソト	名詞サ変*
からー	カラー	名詞サ変*
からーてーま	カラーテーマ	名詞サ変*
からさわ	カラサワ	名詞サ変$
からしにこふ	カラシニコフ	名詞サ変$
からすみ	カラスミ	名詞サ変$
からだ	ｶﾗﾀﾞ	名詞*
からてか	カラテカ	名詞サ変$
からてきっど	カラテキッド	名サ形動*
からどりうす	カラドリウス	名詞サ変*
からみ	カラミ	名サ形動*
かり	カリ	名詞サ変$
かりーな	カリーナ	名詞サ変*
かりなん	カリナン	名詞サ変*
かりびあｎ	カリビアｎ	名詞サ変*
かるだもん	カルダモン	名詞サ変$
かるつ	カルツ	名サ形動*
かるてぃけーや	カルティケーヤ	名詞サ変*
かると	カルト	名詞サ変*
かるな	カルナ	名詞サ変$
かるねーじはーと	カルネージハート	名サ形動*
かるろす	カルロス	名詞サ変*
かれ	カレ	名詞サ変*
かれっか	カレッカ	名詞サ変*
かれりん	カレリン	名サ形動*
かれん	ｶﾚﾝ	名詞*
かれん	カレン	名詞サ変*
かろいど	カロイド	名詞サ変$
かわったとい	変わったと言	ワ行五段*
かわいい	ｶﾜｲｲ	名詞*
かわいかな	河合加奈	固有人他*
かわいそす	カワイソス	名詞サ変*
かわるわけ	変わる訳	名詞$
かわんちゃ	カワンチャ	名詞サ変*
かわんない	カワンナイ	名詞サ変*
かわんない	変わんない	名詞*
かんかん	カンカン	名詞サ変*
かんがえること	考える事	名詞$
かんぎてん	カンギテン	名詞サ変*
かんけー	カンケー	名サ形動*
かんしょうよう	鑑賞洋	名詞*
かんじ	カンジ	名詞サ変$
かんじの	感じ野	名詞$
かんじるよう	感じる様	名詞形動$
かんせつてき	間接敵	名詞$
かんたーる	カンタール	名サ形動*
かんばり	カンバリ	名詞サ変*
かんべん	カンベン	名サ形動*
かんぺ	カンペ	名サ形動*
がっちーず	ガッチーズ	名サ形動*
がっちがち	ガッチガチ	名詞サ変$
がってん	がってん	名詞サ変$
がー	ガー	名詞サ変$
がーるず	ガールズ	名詞サ変*
がい	ガイ	名詞サ変*
がいい	がいい	名詞サ変*
がいいこと	がいい事	名詞*
がいこつ	ガイコツ	名詞サ変$
がいじん	害人	名詞$
がいじん	ガイジン	名詞サ変$
がいでｎ	ガイデｎ	名詞サ変*
がいな	ガイナ	名詞サ変*
がいなっくす	ガイナックス	名詞サ変*
がいる	ガイル	名詞サ変*
がいるが	がいるが	名詞サ変$
がうでぃ	ガウディ	名詞サ変*
がが	ガガ	名詞サ変$
がき	ガキ	名詞サ変*
がぎそん	ガギソン	名詞サ変*
がくと	ガクト	名詞サ変*
がし	が死	ナ行五段*
がすと	ガスト	名サ形動*
がすとら	ガストラ	名詞サ変*
がせ	ガセ	名詞サ変*
がたちら	ガタチラ	名詞サ変$
がち	ガチ	名サ形動*
がちがち	ガチガチ	名詞サ変*
がちの	ガチノ	名サ形動*
がちほも	ガチホモ	名詞サ変*
がちむち	ガチムチ	名サ形動*
がちもん	ガチモン	名詞サ変*
がとつ	ガトツ	名詞サ変*
がどうか	がどうか	名詞サ変*
がねーしゃ	ガネーシャ	名詞サ変*
がのん	ガノン	名サ形動*
がはら	ガハラ	名詞サ変$
がばが	ガバガ	名詞サ変*
がばがば	ガバガバ	名詞サ変*
がぱれ	ガパレ	名詞サ変*
がよい	がよい	名詞サ変*
がら	ガラ	名詞サ変$
がり	ガリ	名詞サ変$
がりょく	画力	名詞*
がりある	ガリアル	名サ形動*
がりでは	ガリデハ	名詞サ変*
がるー	ガルー	名サ形動*
がるーだ	ガルーダ	名詞サ変*
がるーら	ガルーラ	名詞サ変*
がるしゃあ	ガルシャア	名詞サ変$
がるしるど	ガルシルド	名詞サ変$
がるだいん	ガルダイン	名詞サ変*
がるま	ガルマ	名詞サ変*
がれ	ガレ	名詞サ変*
がれふ	ガレフ	名サ形動*
がれりん	ガレリン	名サ形動*
がわる	が悪	形容詞*
がん	ガン	名詞サ変*
がん	がン	名詞サ変*
がんぎまり	ガンギマリ	名詞サ変$
がんじー	ガンジー	名詞サ変*
がんぜめ	ガン攻め	名詞サ変*
がんだた	ガンダタ	名詞サ変$
がんだむ	ガンダム	名詞サ変*
がんてつ	ガンテツ	名詞サ変$
がんとれっと	ガントレット	名詞サ変*
がんぱれ	ガンパレ	名詞サ変*
がんぱれーど	ガンパレード	名詞サ変*
がんぷ	ガンプ	名サ形動*
がんぼ	がんぼ	名詞サ変*
がんぼり	ガン堀	名詞*
がんぼりあ	ガンボリア	名詞サ変$
きゃっと	キャット	名詞サ変*
きゃーきゃー	キャーキャー	名詞サ変*
きゃしゃーん	キャシャーン	名詞サ変*
きゃばくら	キャバクラ	名サ形動*
きゃぷ	キャプ	名サ形動*
きゃぷつば	キャプツバ	名サ形動*
きゃみぃ	キャミィ	名詞サ変*
きゃみい	キャミイ	名詞サ変*
きゃら	キャラ	名詞サ変*
きゃらげ	キャラゲ	名サ形動*
きゃらたい	キャラ対	名詞サ変*
きゃらでざ	キャラデザ	名詞サ変*
きゃんだる	キャンダル	名サ形動*
きゃんと	キャント	名詞サ変*
きゅーば	ｷｭｰﾊﾞ	名詞*
きゅあ	キュア	名詞サ変*
きゅうしゅうでき	吸収出来	一段動詞*
きゅうそく	9則	名詞*
きゅうま	吸魔	名詞*
きゅうろせん	級路線	接尾語$
きゅうろせん	級路線	助数詞$
きゅうろせん	級路線	名詞$
きゅびずむ	キュビズム	名詞サ変$
きゅべれい	キュベレイ	名詞サ変$
きゅん	きゅん	名詞*
きょう	キョウ	名詞サ変*
きょういくでき	教育出来	一段動詞*
きょうかく	胸殻	名詞*
きょうきょう	今日今日	名詞サ変*
きょうしゃ	教者	接尾語*
きょうしつとう	教室棟	名詞$
きょうしん	狂神	名詞*
きょうしんじゃ	狂信者	名詞$
きょうじん	凶人	名詞*
きょうちょう	凶鳥	名詞*
きょうてき	教的	接尾語$
きょうてき	教的	名詞形動$
きょうまな	今日学	バ行五段*
きょがん	巨眼	名詞*
きょき	歔欷	名詞*
きょくう	虚空	名詞*
きょくうそう	虚空爪	名詞*
きょこん	巨根	名詞$
きょり	キョリ	名サ形動*
きょん	キョン	名詞サ変*
きー	キー	名詞サ変*
きーこーど	キーコード	名詞サ変*
きーす	キース	名詞サ変$
きーばいんど	キーバインド	名詞サ変*
きーぱー	キーパー	名詞サ変*
きーぼーど	キーボード	名詞サ変*
きーもあ	キーモア	名詞サ変*
きーわーど	キーワード	名詞サ変*
きうん	キウン	名詞サ変*
きかがく	機科学	名詞サ変$
きくひめ	キクヒメ	名詞サ変$
きしょ	キショ	名詞サ変*
きしどーそーど	キシドーソード	名詞サ変*
きしどーぶれーど	キシドーブレード	名詞サ変*
きじょ	鬼女	名詞*
きすく	キスク	名詞サ変$
きすけ	鬼助	名詞$
きすてぃす	キスティス	名詞サ変*
きずな	キズナ	名詞サ変$
きせん	鬼戦	名詞サ変$
きた	キタ	名詞サ変*
きたー	キター	名詞サ変*
きたいしてないところ	期待してない所	名詞$
きたえるため	鍛えるタメ	名サ形動$
きたら	キタラ	名詞サ変*
きたろ	キタロ	名サ形動*
きたろ	キタロ	名詞サ変*
きたろー	キタロー	名サ形動*
きたろう	喜多郎	名詞*
きちゃった	キチャッタ	名詞サ変$
きちがい	キチガイ	名サ形動*
きちがいすぎ	キチガイ過ぎ	一段動詞*
きちがいだ	キチガイダ	名サ形動*
きつ	キツ	名詞サ変$
きつい	キツイ	名サ形動*
きつい	キツイ	名詞サ変*
きつきつ	キツキツ	名詞サ変*
きつね	キツネ	名詞サ変$
きづ	きづ	名詞サ変*
きなお	き直	サ行五段*
きなん	木何	数詞$
きにする	きにする	名詞サ変$
きの	樹の	名詞サ変*
きのっく	キノック	名詞サ変*
きのした	樹の下	名詞*
きぼんぬ	キボンヌ	名詞サ変*
きまっ	キマッ	名サ形動*
きまいら	キマイラ	名詞サ変*
きまし	キマシ	名詞サ変$
きまし	ｷﾏｼ	名詞サ変$
きませんでしたわー	ｷﾏｾﾝﾃﾞｼﾀﾜｰ	名詞サ変$
きむたく	キムタク	名サ形動*
きむたくなら	キムタクナラ	名サ形動*
きむちちぢみ	キムチチヂミ	名詞サ変$
きむよな	キムヨナ	名詞サ変*
きむら	キムラ	名詞サ変$
きめぇ	キメェ	名サ形動*
きめらあんと	キメラアント	名詞サ変$
きも	キモ	名サ形動*
きも	キモ	名詞サ変*
きもーい	キモーイ	名詞サ変*
きもい	キモイ	名サ形動*
きもく	キモク	名詞サ変*
きもすと	キモスト	名詞サ変*
きもち	キモチ	名詞サ変$
きもてぃー	キモティー	名サ形動*
きもも	木桃	名詞*
きら	キラ	名詞サ変*
きらわれてること	嫌われてる事	名詞*
きり	キリ	名詞サ変*
きりっ	キリッ	名詞サ変*
きりっ	ｷﾘｯ	名詞サ変*
きりーく	キリーク	名サ形動*
きりすと	キリスト	名詞サ変*
きりすときょう	キリストキョウ	名詞サ変*
きりすときょう	キリスト今日	名詞サ変$
きりせんにんしょう	霧仙人掌	名詞*
きりと	キリト	名詞サ変$
きるあ	キルア	名サ形動*
きるびる	キルビル	名サ形動*
きるみー	キルミー	名詞サ変$
きれ	キレ	名詞サ変*
きれい	キレイ	名サ形動*
きれい	キレイ	名詞サ変$
きれいごと	キレイ事	名詞$
きれきれ	キレキレ	名詞サ変*
きれてなーい	キレテナーイ	名サ形動*
きれる	キレル	名詞サ変*
きろく	期六	数詞*
きろばいｔ	キロバイｔ	名詞*
きわみ	キワミ	名サ形動*
きん	キン	名サ形動*
きん	キン	名詞サ変*
きんき	キンキ	名詞サ変*
きんぐ	キング	名詞サ変$
きんぐー	キングー	名詞サ変*
きんぐふろすと	キングフロスト	名詞サ変*
きんぞく	キン族	名詞$
きんたま	キンタマ	名詞サ変*
きんたま	金玉	名詞*
きんにくまん	キンニクマン	名サ形動*
きんは	キンハ	名サ形動*
きんぱく	キンパク	名詞サ変$
きんぼ	キンボ	名サ形動*
きんまもん	キンマモン	名詞サ変*
きんゆうぎょう	金融行	名詞*
ぎゃくいち	逆位置	名詞サ変$
ぎゃぐ	ギャグ	名詞サ変*
ぎゃぐばんど	ギャグバンド	名詞サ変*
ぎゃぷれい	ギャプレイ	名サ形動*
ぎゃらりーふぇいく	ギャラリーフェイク	名詞サ変$
ぎゃるげ	ギャルゲ	名詞サ変*
ぎゅす	ギュス	名サ形動*
ぎょろあえ	ギョロアエ	名詞サ変$
ぎがす	ギガス	名詞サ変$
ぎがびっと	ギガビット	名詞サ変*
ぎく	ぎく	名詞サ変*
ぎぐす	ギグス	名サ形動*
ぎぐす	ギグス	名詞サ変$
ぎじぇるも	ギジェルモ	名詞サ変$
ぎす	ギス	名サ形動*
ぎすぎす	ギスギス	名サ形動*
ぎりぎり	ギリギリ	名詞サ変*
ぎりしゃ	ギリシャ	名詞サ変*
ぎりす	ギリス	名詞サ変$
ぎりめから	ギリメカラ	名詞サ変*
ぎれん	ギレン	名詞サ変*
ぎん	ギン	名詞サ変*
ぎんこーる	ギンコール	名詞サ変*
ぎんせい	銀星	名詞$
くぃーん	クィーン	名詞サ変*
くぉーつ	クォーツ	名詞サ変*
くぉくぉあ	クォクォア	名詞サ変*
くぉくぉあ	ｸｫｸｫｱ	名詞サ変$
くっそ	クッソ	名詞サ変*
くっそきたな	くっそ汚	形容詞*
くっそきたな	クッソ汚	形容詞*
くー・ふーりん	クー・フーリン	名詞サ変*
くーでるか	クーデルカ	名サ形動*
くーふーりん	クーフーリン	名詞サ変*
くーらー	クーラー	名詞サ変*
くーらへ	クーラヘ	名詞サ変*
くーろん	クーロン	名詞サ変*
くーろんずげーと	クーロンズゲート	名詞サ変*
くいーんあんと	クイーンアント	名詞サ変*
くいーんずないん	クイーンズナイン	名詞サ変*
くいーんぼんてーじ	クイーンボンテージ	名詞サ変*
くいしばり	クイシバリ	名詞サ変*
くいなる	クイナル	名詞サ変$
くうき	くうき	名詞*
くうそう	空爪	名詞*
くうのがよ	喰うのが良	形容詞*
くおーてぃ	クオーティ	名詞サ変*
くおりてぃ	クオリティ	名詞サ変*
くくのち	ククノチ	名詞サ変*
くぐまっつ	クグマッツ	名詞サ変*
くけい	句型	接尾語$
くけい	句型	助数詞$
くさぁい	クサァイ	名詞サ変$
くさい	クサイ	名詞サ変*
くさそう	草草	名詞$
くさむら	クサムラ	名詞サ変$
くさやはや	草やはや	名詞サ変$
くさやはやすな	草やはや砂	名詞$
くし	クシ	名サ形動*
くしゃな	クシャナ	名詞サ変*
くしみたま	クシミタマ	名詞サ変*
くじ	クジ	名詞サ変*
くす	クス	名詞サ変*
くすり	クスリ	名サ形動*
くすり	ｸｽﾘ	名詞*
くすり	クスリ	名詞サ変$
くず	クズ	名詞サ変*
くずは	クズハ	名詞サ変$
くせ	クセ	名サ形動*
くそ	クソ	名サ形動*
くそ	クソ	名詞サ変*
くそがき	クソガキ	名詞サ変$
くそげ	クソゲ	名サ形動*
くそげー	クソゲー	名詞サ変*
くそまみれ	糞まみれ	名詞$
くそわろた	クソワロタ	名詞サ変$
くたー	クター	名詞サ変$
くだ	クダ	名詞サ変*
くだらないとこ	くだらない床	名詞$
くちばし	クチバシ	名詞サ変*
くつうが	苦痛蛾	名詞*
くつうが	苦痛が	接続詞$
くとぅるふ	クトゥルフ	名詞サ変$
くどい	クドイ	名詞サ変*
くどらく	クドラク	名詞サ変*
くない	くない	名詞サ変*
くに	クニ	名詞サ変$
くにのため	国のタメ	名サ形動*
くび	クビ	名サ形動*
くびど	クビド	名詞サ変$
くべつでき	区別出来	一段動詞*
くぼつか	窪塚	名詞*
くま	クマ	名詞サ変$
くまなし	隈なし	名詞*
くもいと	蜘蛛糸	名詞*
くらいふ	くらいふ	名詞*
くらいふ	クライフ	名詞サ変*
くらいまっくす	クライマックス	名詞サ変*
くらうど	クラウド	名サ形動*
くらくら	クラクラ	名詞サ変$
くらこん	クラコン	名詞サ変$
くらしあん	クラシアン	名サ形動*
くらせるわけ	暮らせる訳	名詞*
くらぴか	クラピカ	名サ形動*
くらぴか	クラピカ	名詞サ変*
くらべんな	比べんな	名詞*
くらま	蔵魔	名詞$
くらま	倉間	固有人姓$
くらまてんぐ	クラマテング	名詞サ変*
くらりす	クラリス	名サ形動*
くらん	クラン	名サ形動*
くりっぷぼーど	クリップボード	名詞サ変*
くりー	クリー	名サ形動*
くりあ	クリア	名詞サ変*
くりえいたー	クリエイター	名サ形動*
くりくり	栗栗	名詞*
くりくり	クリクリ	名詞サ変$
くりくりっ	クリクリッ	名詞サ変$
くりしゅまるど	クリシュマルド	名詞サ変*
くりしても	クリシテモ	名詞サ変$
くりすたっかー	クリスタッカー	名詞サ変*
くりすらる	クリスラル	名詞サ変*
くりにっく	クリニック	名詞サ変*
くりぼー	クリボー	名詞サ変*
くりむ	クリム	名サ形動*
くりるろな	クリルロナ	名サ形動*
くりろな	クリロナ	名サ形動*
くりろな	クリロナ	名詞サ変*
くりろなは	クリロナハ	名詞サ変*
くる	クル	名詞サ変*
くるーすにく	クルースニク	名詞サ変*
くるど	クルド	名詞サ変*
くれいとす	クレイトス	名サ形動*
くれいもあ	クレイモア	名詞サ変*
くれか	クレカ	名詞サ変$
くれは	クレハ	名サ形動*
くれよぉー	クレヨォー	名サ形動*
くろ	クロ	名詞サ変*
くろっく	クロック	名詞サ変*
くろーざー	クローザー	名詞サ変*
くろすでぃ	クロスディ	名詞サ変*
くろだ	クロダ	名詞サ変$
くろと	クロト	名詞サ変*
くろの	クロノ	名サ形動*
くろの	クロノ	名詞サ変$
くろの・すとーん	クロノ・ストーン	名詞サ変$
くろりあん	クロリアン	名サ形動*
くろろ	クロロ	名サ形動*
くろん	クロン	名サ形動*
くわい	クワイ	名サ形動*
くわのみ	桑の実	名詞*
くんんあ	クンンア	名サ形動*
ぐっじょぶ	ｸﾞｯｼﾞｮﾌﾞ	名詞*
ぐっず	グッズ	名詞サ変$
ぐーぱん	グーパン	名詞サ変*
ぐーる	グール	名サ形動*
ぐーる	グール	名詞サ変*
ぐーるど	グールド	名詞サ変*
ぐーん	グーン	名詞サ変$
ぐうせい	ぐう聖	接頭語$
ぐくまっつ	グクマッツ	名詞サ変*
ぐぐれかす	ググレカス	名詞サ変*
ぐす	グス	名サ形動*
ぐだぐた	グダグタ	名詞サ変*
ぐだぐだ	グダグダ	名サ形動*
ぐとく	愚得	名サ形動$
ぐら	グラ	名サ形動*
ぐら	グラ	名詞サ変*
ぐらっふぃっく	グラッフィック	名詞サ変*
ぐらてん	グラテン	名詞サ変*
ぐらでぃえーたー	グラディエーター	名サ形動*
ぐらふぃっく	グラフィック	名詞サ変*
ぐらふぃっくかーど	グラフィックカード	名詞サ変*
ぐらぼ	グラボ	名詞サ変*
ぐらむ	グラム	名詞サ変*
ぐらんつーりすも	グランツーリスモ	名詞サ変*
ぐらんどたっく	グランドタック	名詞サ変*
ぐりっど	グリッド	名詞サ変*
ぐりーぶ	グリーブ	名詞サ変*
ぐりふぉん	グリフォン	名詞サ変*
ぐりるろじっく	グリルロジック	名サ形動*
ぐるーす	グルース	名詞サ変*
ぐるーぷか	グループ課	名詞*
ぐるど	グルド	名詞サ変*
ぐるめ	グルメ	名詞サ変*
ぐるる	グルル	名詞サ変*
ぐれーどあっくす	グレードアックス	名詞サ変*
ぐれい	グレイ	名詞サ変*
ぐれいに	グレイ似	一段動詞*
ぐれいふぉっくす	グレイフォックス	名詞サ変*
ぐれて	グレテ	名詞サ変$
ぐれねーど	グレネード	名詞サ変*
ぐれむりん	グレムリン	名詞サ変*
ぐれる	グレる	名詞*
ぐれる	グレル	名詞サ変*
ぐれんてる	グレンテル	名詞サ変*
ぐろ	グロ	名詞サ変*
ぐろい	グロイ	名詞サ変*
ぐろいざー	グロイザー	名詞サ変*
ぐろく	グロく	名詞*
ぐろくない	グロくない	名詞サ変*
ぐんぐにる	グングニル	名詞サ変$
ぐんまー	グンマー	名詞サ変$
けっとしー	ケットシー	名詞サ変*
けっぺん	ケッペン	名詞サ変$
けーで	ケーデ	名詞サ変*
けーびー	ケービー	名詞サ変$
けーぷ	ケープ	名詞サ変*
けーん	ケーン	名サ形動*
けい	ケイ	名詞サ変*
けいさんでき	計算出来	一段動詞*
けいししゃ	刑死者	名詞$
けいじ	啓詞	固有人名$
けいじ	形而	名詞サ変*
けいじゃん	ケイジャン	名サ形動*
けいじか	啓詞化	名詞サ変$
けいす	ケイス	名詞サ変*
けいすけ	ケイスケ	名詞サ変*
けいと	ケイト	名詞サ変*
けいねす	ケイネス	名詞サ変$
けいぶ	ケイブ	名詞サ変*
けいる	ケイル	名詞サ変*
けし	ケシ	名詞サ変*
けつ	ケツ	名サ形動*
けつ	ケツ	名詞サ変*
けつあるかとる	ケツアルカトル	名詞サ変*
けつあるくあとる	ケツアルクアトル	名詞サ変*
けつこ	ケツコ	名サ形動*
けは	気歯	名詞*
けふぃあ	ケフィア	名サ形動*
けも	ケモ	名詞サ変$
けものよけ	獣避け	名詞*
けりー	ケリー	名詞サ変*
けると	ケルト	名詞サ変$
けるぬんのす	ケルヌンノス	名詞サ変*
けるぷ	ケルプ	名詞サ変*
けるべろす	ケルベロス	名詞サ変*
けん	ケン	名詞サ変*
けん	ｋｅｎ	名詞サ変$
けんぎょ	剣魚	名詞*
けんしろう	ケンシロウ	名サ形動*
けんじょう	剣状	名詞*
けんせい	剣聖	接頭語$
けんぢ	ケンヂ	名サ形動*
けんぷ	ケンプ	名サ形動*
げっくす	ゲックス	名サ形動*
げー	ゲー	名サ形動*
げー	ゲー	名詞サ変*
げーか	ゲーカ	名詞サ変*
げーときーぱー	ゲートキーパー	名詞サ変*
げーみんぐ	ゲーミング	名サ形動*
げーむこんてすと	ゲームコンテスト	名詞サ変*
げーむし	ゲーム史	名詞*
げーむすれ	ゲームスレ	名詞サ変$
げーむたいとる	ゲームタイトル	名サ形動*
げーむぼーい	ゲームボーイ	名詞サ変*
げい	ゲイ	名詞サ変*
げいが	ゲイガ	名詞サ変*
げいこう	芸工	名詞$
げいじ	ゲイジ	名詞サ変$
げいとか	ゲイトカ	名サ形動*
げいなっくす	ゲイナックス	名詞サ変*
げいら	ゲイラ	名サ形動*
げいる	ゲイル	名詞サ変$
げげげ	ゲゲゲ	名サ形動*
げげる	ゲゲル	名詞サ変$
げざー	ゲザー	名詞サ変$
げす	ゲス	名詞サ変*
げすい	ゲスイ	名詞サ変*
げど	ゲド	名サ形動*
げは	ゲハ	名詞サ変$
げむ	ゲム	名詞サ変$
げるぎえふ	ゲルギエフ	名詞サ変*
げろ	ゲロ	名詞サ変*
げんじゅう	幻獣	名詞サ変*
げんどう	ゲンドウ	名詞サ変*
げんぶ	ゲンブ	名詞サ変*
げんま	幻魔	名詞*
こっぱてんぐ	コッパテング	名詞サ変*
こー	コー	名詞サ変$
こーす	コース	名詞サ変*
こーでっく	コーデック	名詞サ変*
こーでっく	コーデック	名サ形動*
こーとはーでぃ	コートハーディ	名詞サ変*
こーねふ	コーネフ	名詞サ変$
こーひー	コーヒー	名詞サ変*
こーら	コーラ	名詞サ変*
こいけや	コイケヤ	名サ形動*
こいつら	こいつら	名詞$
こう	コウ	名詞サ変*
こうが	黄河	名詞*
こうけいさく	後継策	名詞サ変*
こうこうそおか	コウコウソオカ	名詞サ変$
こうじ	コウジ	名詞サ変$
こうていか	肯定化	名詞サ変*
こうまきょう	紅魔郷	名詞*
こうめい	コウメイ	名詞サ変$
こうもくてん	コウモクテン	名詞サ変*
こうりゅう	コウリュウ	名詞サ変*
こえな	声な	名詞*
こえるとき	超える時	名詞*
こおり	コオリ	名詞サ変*
こか・こーら	コカ・コーラ	名詞サ変*
こかくちょう	コカクチョウ	名詞サ変*
こが	虎芽	名詞*
こくじん	こくじん	名詞サ変*
こくめいかん	刻銘間	名詞*
こくめいかん	刻命館	名詞*
こくんりーと	コクンリート	名詞サ変$
こけ	コケ	名詞サ変*
こけいちご	コケイチゴ	名詞サ変*
こけて	コケテ	名詞サ変*
こけふ	コケ府	名詞*
ここまではや	ここまで流行	ラ行五段*
こころ	ココロ	名詞サ変$
こさきん	コサキン	名詞サ変$
こしだけ	腰岳	名詞$
こしまえー	ｺｼﾏｴｰ	名詞サ変$
こす	コス	名詞サ変*
こすとこ	コストコ	名詞サ変*
こだま	コダマ	名サ形動*
こていしない	固定市内	名詞*
こと	コト	名詞サ変*
こども	コドモ	名詞サ変$
こなみ	コナミ	名詞サ変*
こにこ	コニコ	名詞サ変*
こにし	コニシ	名詞サ変$
このかね	この金	名詞*
このなかでしょう	この中で硝	名詞*
このようなこと	このような事	名詞*
こは	コハ	名サ形動*
こぼ	コボ	名詞サ変$
こまかいところ	細かい所	名詞$
こまるわけ	困る訳	名詞$
こまんど	コマンド	名詞サ変*
こまんどぷろんぷと	コマンドプロンプト	名詞サ変*
こみゅ	コミュ	名サ形動*
こみゅ	コミュ	名詞サ変*
こみゅしょう	コミュ障	名詞サ変*
こみゅねー	コミュネー	名サ形動*
こみっく	コミック	名詞サ変*
こむ	コム	名詞サ変$
こめ	コメ	名詞サ変*
こめつき	※月	名詞*
こら	コラ	名詞サ変*
こられす	コラレス	名詞サ変$
こり	コリ	名詞サ変*
こるちゃ	コルチャ	名サ形動*
こるてす	コルテス	名詞サ変*
こるねお	コルネオ	名詞サ変$
これ	コレ	名詞サ変$
これじゃなーい	ｺﾚｼﾞｬﾅｰｲ	名詞サ変$
これじゃないろぼ	コレジャナイロボ	名詞サ変*
これよう	これ洋	名詞*
ころっせお	コロッセオ	名詞サ変$
ころころ	コロコロ	名詞サ変*
ころされた	コロサレタ	名詞サ変$
ころだけ	コロダケ	名サ形動*
ころとらんぐる	コロトラングル	名詞サ変*
ころまる	コロマル	名サ形動*
こわい	コワイ	名詞サ変$
こわくしすぎ	怖くしすぎ	一段動詞*
こん	コン	名サ形動*
こん	コン	名詞サ変$
こんごともしくよろ	コンゴトモシクヨロ	名詞サ変*
こんしゅーま	コンシューマ	名詞サ変*
こんしゅーまー	コンシューマー	名詞サ変*
こんせき	混石	名詞*
こんせんとれいと	コンセントレイト	名詞サ変*
こんそーる	ｺﾝｿｰﾙ	名詞サ変*
こんだけ	こんだけ	名詞サ変*
こんてすと	コンテスト	名詞サ変*
こんと	コント	名詞サ変*
こんとろーせ	コントローセ	名詞サ変*
こんとろーら	コントローラ	名詞サ変*
こんとろーるでき	コントロール出来	一段動詞*
こんなこと	こんなこと	名詞サ変*
こんなことでき	こんなこと出来	一段動詞$
こんなとこで	こんなとこで	名詞サ変*
こんなところに	こんなところに	名詞サ変$
こんなん	こんなん	名詞サ変*
こんばーた	コンバータ	名詞サ変*
こんばいら	コンバイラ	名詞サ変*
こんばいる	コンバイル	名詞サ変*
こんぱいら	コンパイラ	名詞サ変*
こんぴゅーた	コンピュータ	名詞サ変*
こんふぃぐ	コンフィグ	名詞サ変*
こんれんとれいと	コンレントレイト	名詞サ変*
ごっく	ゴック	名詞サ変*
ごっとぅーざ	ゴットゥーザ	名詞サ変$
ごっどふぁーざー	ゴッドファーザー	名サ形動*
ごっどまん	ゴッドマン	名詞サ変*
ごっほ	ゴッホ	名詞サ変*
ごー	ゴー	名詞サ変*
ごーたま	ゴータマ	名詞サ変*
ごーるでんあい	ゴールデンアイ	名サ形動*
ごーるでんばっと	ゴールデンバット	名詞サ変$
ごあ	ゴア	名詞サ変*
ごいや	語イヤ	名詞サ変*
ごうえん	豪炎	名詞$
ごうき	豪鬼	名詞$
ごうきょう	豪教	名詞$
ごうそう	剛爪	名詞*
ごかしんえんせん	五火神焔扇	名詞*
ごき	ゴキ	名詞サ変$
ごぐ	ゴグ	名詞サ変*
ごぐまごぐ	ゴグマゴグ	名詞サ変*
ごさく	ごさく	名詞*
ごさく	悟作	固有人名$
ごさく	五作	固有人名$
ございます	ｺﾞｻﾞｲﾏｽ	名詞サ変$
ごしっく	ゴシック	名詞サ変*
ごじょー	ゴジョー	名詞サ変$
ごじら	ゴジラ	名詞サ変*
ごす	ゴス	名サ形動*
ごたごた	ゴタゴタ	名詞サ変*
ごだい	御大	接頭語*
ごつ	ゴツ	名サ形動*
ごつい	ゴツイ	名サ形動*
ごぶ	ゴブ	名詞サ変*
ごみ	ゴミ	名詞サ変*
ごみか	ゴミ化	接尾語*
ごみか	ゴミ化	サ変動詞*
ごもりー	ゴモリー	名詞サ変*
ごやく	語訳	名詞サ変*
ごり	ゴリ	名サ形動*
ごり	ゴリ	名詞サ変$
ごりあて	ゴリアテ	名サ形動*
ごりまー	ゴリマー	名サ形動*
ごるご	ゴルゴ	名サ形動*
ごれいぬ	ゴレイヌ	名詞サ変$
ごろ	ゴロ	名詞サ変*
ごろー	ゴロー	名詞サ変*
ごろごろ	ゴロゴロ	名詞サ変*
ごわごわ	ゴワゴワ	名詞サ変*
ごん	ゴン	名サ形動*
ごんごろう	ゴンゴロウ	名サ形動*
さっかん	サッカン	名サ形動*
さっきょくか	作曲可	名詞*
さっだん	サッダン	名サ形動*
さっぷ	サップ	名サ形動*
さっぷうげき	サップウゲキ	名詞サ変*
さっぷうげき	殺風激	名詞*
さっぽろしとよひらく	サッポロシトヨヒラク	名詞サ変*
さっぽろしとよひらく	札幌市豊平区	固有地名$
さーぐらす	サーグラス	名サ形動*
さーこーと	サーコート	名詞サ変*
さーせん	サーセン	名詞サ変*
さーにゃを	ｻｰﾆｬｦ	名詞サ変$
さーにゃをそんなめでみんなー	ｻｰﾆｬｦｿﾝﾅﾒﾃﾞﾐﾝﾅｰ	名詞サ変$
さい	サイ	名詞サ変*
さい	ｓａｉ	名詞サ変$
さいあ	サイア	名詞サ変$
さいいんすとーる	サイインストール	名詞サ変*
さいいんすとーる	再インストール	名詞サ変*
さいう	彩雨	名詞*
さいく	サイク	名サ形動*
さいくろっぷす	サイクロップス	名詞サ変$
さいけ	サイケ	名詞サ変$
さいけん	砕拳	名詞*
さいこ	サイコ	名詞サ変$
さいこう	さいこう	名詞サ変*
さいこぱす	サイコパス	名詞サ変*
さいこら	サイコラ	名詞サ変$
さいざー	サイザー	名詞サ変*
さいしんばん	最新番	名詞*
さいず	サイズ	名詞サ変*
さいぞー	サイゾー	名詞サ変*
さいてー	サイテー	名詞サ変*
さいとう	サイトウ	名サ形動*
さいとう	サイトウ	名詞サ変*
さいとうこう	齋藤工	名詞$
さいとうじゅん	サイトウジュン	名詞サ変*
さいとうじゅん	齋藤純	名詞形動*
さいとうじゅん	齋藤順	名詞$
さいばーうぉー	サイバーウォー	名サ形動*
さいばい	サイバイ	名サ形動*
さいふぁー	サイファー	名サ形動*
さいふぁー	サイファー	名詞サ変*
さいべり	サイベリ	名サ形動*
さいべりあ	サイベリア	名サ形動*
さいぼーぐ	サイボーグ	名詞サ変*
さいやじん	サイヤジン	名サ形動*
さいやじん	サイや人	名詞$
さう゛ぁん	サヴァン	名サ形動*
さか	サカ	名詞サ変$
さかい	サカイ	名詞サ変$
さからうこと	逆らう事	名詞*
さが	サガ	名詞サ変*
さがっと	サガット	名詞サ変*
さがみねた	サガミネタ	名詞サ変*
さき	サキ	名詞サ変$
さきゅばす	サキュバス	名詞サ変*
さきみたま	サキミタマ	名詞サ変*
さくみ	さ組	名詞*
さくみが	サクミガ	名詞サ変*
さくら	サクラ	名詞サ変*
さけす	サケス	名詞サ変*
さけばれてるとき	叫ばれてる時	名詞$
さげ	サゲ	名サ形動*
ささげること	捧げる事	名詞$
ささみ	ササミ	名詞サ変*
さされるぞ	ササレルゾ	名サ形動*
さざん	サザン	名詞サ変*
さし	サシ	名詞サ変*
さしう	サシウ	名詞サ変*
さじたりうす	サジタリウス	名詞サ変*
さすけ	サスケ	名詞サ変*
さすけぇ	サスケェ	名詞サ変*
さすぺんす	サスペンス	名詞サ変*
さとう	サトウ	名詞サ変*
さとか	差とか	名詞サ変*
さとくりふ	サトクリフ	名詞サ変$
さとし	サトシ	名詞サ変*
さば	サバ	名詞サ変$
さばいばー	サバイバー	名詞サ変*
さぶぼりゅーむ	サブボリューム	名詞サ変*
さま	サマ	名サ形動*
さまえる	サマエル	名詞サ変*
さまりかーむ	サマリカーム	名詞サ変*
さむぅぃ	サムゥィ	名詞サ変$
さむい	サムイ	名サ形動*
さむいさむい	ｻﾑｲｻﾑｲ	名詞サ変$
さむね	サムネ	名サ形動*
さむらい	サムライ	名詞サ変*
さや	サヤ	名詞サ変$
さら	サラ	名詞サ変*
さらさら	サラサラ	名詞サ変$
さらし	サラシ	名詞サ変$
さらすばてぃ	サラスバティ	名詞サ変*
さらだ	サラダ	名詞サ変*
さらまんだー	サラマンダー	名詞サ変*
さらりまん	サラリマン	名詞サ変$
さりー	サリー	名詞サ変*
さる	サル	名詞サ変$
さわいでること	騒いでる事	名詞*
さんが	サンガ	名詞サ変$
さんしょう	サンショウ	名詞サ変*
さんだー	サンダー	名詞サ変*
さんだーばーど	サンダーバード	名詞サ変*
さんだーらぶ	サンダーラブ	名詞サ変*
さんとら	サントラ	名詞サ変$
ざっくーむ	ザックーム	名詞サ変*
ざっさー	ザッサー	名詞サ変*
ざーぼん	ザーボン	名詞サ変$
ざーめん	ザーメン	名詞サ変$
ざく	ザク	名サ形動*
ざこ	ザコ	名サ形動*
ざご	ザゴ	名詞サ変*
ざとうい	ザトウイ	名サ形動*
ざの	座野	名詞*
ざべす	ザベス	名サ形動*
ざわーくらうと	ザワークラウト	名詞サ変$
ざんき	残機	名詞*
ざんぎ	ザンギ	名詞サ変*
ざんす	ザンス	名サ形動*
ざんとまん	ザントマン	名詞サ変*
ざんまとう	斬魔刀	名詞*
しぇっｌ	シェル	名サ形動$
しぇー	シェー	名詞サ変*
しぇーんべるく	シェーンベルク	名詞サ変*
しぇりー	シェリー	名詞サ変*
しぇる	シェル	名詞サ変*
しゃ	シャ	名サ形動*
しゃーりー	シャーリー	名詞サ変*
しゃーれい	シャーレイ	名詞サ変$
しゃあ	シャア	名サ形動*
しゃあ	シャア	名詞サ変*
しゃうと	シャウト	名サ形動*
しゃくさ	尺差	名詞$
しゃざらんと	シャザラント	名詞サ変*
しゃだい	シャダイ	名詞サ変*
しゃどう	シャドウ	名詞サ変*
しゃどうあすぴす	シャドウアスピス	名詞サ変*
しゃどうえんとり	シャドウエントリ	名詞サ変*
しゃどうげいと	シャドウゲイト	名サ形動*
しゃな	シャナ	名サ形動*
しゃば	シャバ	名詞サ変$
しゃび	シャビ	名詞サ変$
しゃべんね	喋んね	名詞*
しゃわー	シャワー	名詞サ変*
しゅ	シュ	名サ形動*
しゅ	シュ	名詞サ変*
しゅー	シュー	名詞サ変*
しゅーら	シューラ	名詞サ変$
しゅいん	手淫	名詞サ変$
しゅう	シュウ	名詞サ変$
しゅう	しゅう	名詞サ変$
しゅうくん	シュウ君	名詞$
しゅうしゅう	集臭	接尾語*
しゅうしゅう	集臭	助数詞*
しゅうしょくでき	就職出来	一段動詞*
しゅうそく	終速	名詞*
しゅうてん	シュウ天	名詞$
しゅたーる	シュタール	名サ形動*
しゅみで	趣味出	一段動詞$
しゅると	シュルト	名サ形動*
しゅわ	シュワ	名サ形動*
しゅわるつねっがー	シュワルツネッガー	名サ形動*
しゅん	シュン	名詞サ変$
しょ	ショ	名サ形動*
しょー	ショー	名詞サ変*
しょーがない	しょーがない	名詞サ変*
しょーびず	ショービズ	名詞サ変*
しょうかい	小塊	名詞*
しょうがない	ショウガナイ	名サ形動*
しょうがない	しょうがない	名詞サ変$
しょうがないね	しょうがないね	名詞サ変$
しょうしつ	蕭瑟	名詞*
しょうじ	ショウジ	名詞サ変*
しょうじょう	ショウジョウ	名詞サ変*
しょうもん	摂モン	名サ形動*
しょうもん	硝モン	名サ形動*
しょうもん	翔門	名詞*
しょうりのちゃくら	ショウリノチャクラ	名詞サ変*
しょうりのちゃくら	勝利のチャクラ	名詞サ変*
しょきいち	初期位置	名詞サ変*
しょくいん	ショクイン	名詞サ変*
しょくじめにゅー	しょくじめにゅー	名詞*
しょくじめにゅー	ショクジメニュー	名サ形動*
しょすたこーう゛ぃち	ショスタコーヴィチ	名詞サ変$
しょすたこーびっち	ショスタコービッチ	名詞サ変$
しょた	ショタ	名サ形動*
しょた	ショタ	名詞サ変*
しょぼい	ショボイ	名詞サ変*
しょぼさ	ショボサ	名詞サ変*
しょんべん	ションベン	名サ形動*
しっ	シッ	名詞サ変*
しっ	しっ	名詞サ変*
しっぷうぶーすた	シップウブースタ	名詞サ変*
しっぷうぶーすた	疾風ブースタ	名詞サ変*
しーさー	シーサー	名詞サ変*
しーざー	シーザー	名詞サ変*
しーもあ	シーモア	名詞サ変*
しーりー	シーリー	名詞サ変$
しーるどすまいと	シールドスマイト	名詞サ変*
しーん	シーン	名詞サ変*
しあ	シア	名詞サ変$
しあいでき	試合出来	一段動詞*
しいろ	死色	名詞*
しうてくとり	シウテクトリ	名詞サ変*
しう゛ぁ	シヴァ	名詞サ変*
しう゛ぃらいぜーしょん	シヴィライゼーション	名詞サ変$
しう゛あ	シヴア	名詞サ変*
しえる	シエル	名サ形動*
しえる	シエル	名詞サ変*
しおひ	潮非	名詞$
しか	シカ	名詞サ変$
しかけられてるわけ	仕掛けられてる訳	名詞*
しが	誌画	名詞*
しがー	シガー	名詞サ変$
しがしんご	シガシンゴ	名詞サ変$
しがりーた	シガリータ	名詞サ変$
しき	屍鬼	名詞*
しく	シク	名詞サ変$
しぐるい	死狂い	接尾語$
しぐるい	死狂い	助数詞$
しぐるい	死狂い	サ変動詞$
しげ	シゲ	名サ形動*
しげみ	茂美	名詞$
しこ	シコ	名詞サ変*
しこった	シコッタ	名サ形動*
しこう	死甲	名詞$
しこうちゅう	死甲蟲	名詞$
しこしこ	シコシコ	名サ形動*
しこしこ	ｼｺｼｺ	名詞*
しこり	シコリ	名詞サ変*
しこりよう	シコリ用	名詞*
しざーす	シザース	名詞サ変*
しじょん	シジョン	名詞サ変$
しす	シス	名サ形動*
しすげむ	シスゲム	名サ形動*
しすしす	シスシス	名サ形動*
しぜんなこと	自然な事	名詞$
した	↓	名詞*
したいげり	死体蹴り	名詞サ変*
したすくろーる	シタスクロール	名詞サ変*
したすくろーる	下スクロール	名詞サ変*
したにはした	下には下	接尾語$
したにはした	下には下	名詞$
しちゅ	シチュ	名詞サ変$
しちゅあ	シチュア	名サ形動*
してん	してん	名詞サ変*
しでぃあす	シディアス	名サ形動*
しでぃある	シディアル	名サ形動*
しど	シド	名詞サ変*
しどにー	シドニー	名詞サ変*
しな	シナ	名サ形動*
しないこと	しない事	名詞$
しなければ	シナケレバ	名サ形動*
しなちく	しなちく	名詞*
しなないとい	死なないと言	ワ行五段*
しに	死に	名詞サ変*
しにがみ	死苦み	名詞*
しにがみ	死神	名詞*
しね	シネ	名サ形動*
しねもら	シネモラ	名詞サ変$
しばぶー	シバブー	名詞サ変*
しばむらてぃっくばらんす	シバムラティックバランス	名詞サ変$
しびらいぜーしょん	シビライゼーション	名詞サ変$
しぼくむら	シボクムラ	名詞サ変$
しみんのため	市民のタメ	名サ形動$
しむ	シム	名詞サ変$
しも	シモ	名サ形動*
しも	シモ	名詞サ変*
しもに	下二	数詞$
しもへいへ	シモヘイヘ	名詞サ変$
しらないわけ	知らない訳	名詞*
しらね	知らね	名詞*
しらねー	知らねー	名詞*
しらべる	シラベル	名詞サ変*
しられたわけ	知られた訳	名詞$
しらんだろ	しらんだろ	名詞サ変*
しらんの	知らんの	名詞*
しりある	シリアル	名詞サ変*
しる	シル	名詞サ変*
しるきー	シルキー	名詞サ変*
しるてぃほるん	シルティホルン	名詞サ変*
しるとし	知る年	名詞*
しるばー	シルバー	名詞サ変*
しるばーしーるど	シルバーシールド	名詞サ変*
しるばーぼらんてぃあ	シルバーボランティア	名サ形動*
しるびあ	シルビア	名詞サ変*
しるふ	シルフ	名詞サ変*
しるふぃーど	シルフィード	名詞サ変*
しるふぃほるん	シルフィホルン	名詞サ変*
しるぶぷれ	シルブプレ	名詞サ変*
しろーと	シロート	名サ形動*
しろうさぎ	シロウサギ	名詞サ変*
しろうまさむね	士郎正宗	名詞*
しろくま	シロクマ	名サ形動*
しろん	白ン	名詞サ変*
しわんな	シワンナ	名詞サ変*
しん	シン	名詞サ変*
しんあい	心愛	名詞サ変*
しんかい	神回	名詞*
しんかくりょう	新カクリョウ	名詞サ変$
しんきょく	シンキョク	名詞サ変*
しんぎょう	信行	名詞$
しんぐるとん	シングルトン	名サ形動*
しんご～しんご～	シンゴ～シンゴ～	名詞サ変*
しんじ	シンジ	名サ形動*
しんじ	シンジ	名詞サ変$
しんじゃ	シンジャ	名サ形動*
しんじゅ	神樹	名詞*
しんじゅく	シンジュク	名詞サ変*
しんじられるわけ	信じられる訳	名詞*
しんじん	神人	名詞*
しんせ	シンセ	名詞サ変*
しんせつな	しんせつな	名詞サ変*
しんだけ	死んだ毛	名詞$
しんてつ	真鉄	名詞*
しんでくれる	シンデクレル	名詞サ変*
しんぶ	芯部	名詞*
しんぷるな	シンプル名	名詞*
しんぼぴ	シンボピ	名詞サ変*
しんようでき	信用出来	一段動詞*
しんらいでき	信頼出来	一段動詞*
じ	士	単漢字$
じ・えっじ	ジ・エッジ	名詞サ変$
じぇい・れの	ジェイ・レノ	名詞サ変*
じぇくと	ジェクト	名詞サ変*
じぇだい	ジェダイ	名サ形動*
じぇらーど	ジェラード	名サ形動*
じぇらーと゜	ジェラート゜	名詞サ変*
じゃ	ジャ	名詞サ変*
じゃっくふろすと	ジャックフロスト	名詞サ変*
じゃっくらんたん	ジャックランタン	名詞サ変*
じゃっじめんと	ジャッジメント	名詞サ変*
じゃっぷ	ジャップ	名サ形動*
じゃーにー	ジャーニー	名詞サ変*
じゃあ	ジャア	名詞サ変*
じゃあくふろすと	ジャアクフロスト	名詞サ変*
じゃいろぜったー	ジャイロゼッター	名詞サ変$
じゃきがん	邪気眼	名詞*
じゃぎ	ジャギ	名サ形動*
じゃくそん	ジャクソン	名詞サ変*
じゃこう	ジャ香	名詞*
じゃこびーに	ジャコビーニ	名詞サ変*
じゃなかったらい	じゃなかったら良	形容詞*
じゃねっと	ジャネット	名詞サ変*
じゃばうぉっく	ジャバウォック	名サ形動*
じゃぶろー	ジャブロー	名詞サ変*
じゃみとふ	ジャミトフ	名サ形動*
じゃりゅう	邪龍	名詞*
じゃれっと	ジャレット	名詞サ変$
じゃんばう゛ぁん	ジャンバヴァン	名詞サ変*
じゃんぱう゛ぁん	ジャンパヴァン	名詞サ変*
じゃんぴんぐ	ジャンピング	名サ形動*
じゃんりｎ	ジャンリｎ	名詞サ変*
じゃんるか	ジャンルカ	名詞サ変$
じゅうかん	獣姦	名詞*
じゅうが	獣餓	名詞*
じゅうたいせい	銃耐性	名詞*
じゅうどうのよう	柔道の様	名詞形動$
じゅうどうは	柔道歯	名詞$
じゅうの	銃野	名詞*
じゅうぶんすぎ	十分過ぎ	一段動詞*
じゅけんび	受験微	名詞$
じゅさつ	呪殺	名詞*
じゅだ	ジュダ	名サ形動*
じゅにーにょ	ジュニーニョ	名詞サ変$
じゅぴたー	ジュピター	名詞サ変*
じゅらる	ジュラル	名サ形動*
じゅらる	ジュラル	名詞サ変*
じゅん	ジュン	名詞サ変*
じゅん	ｼﾞｭﾝ	名詞サ変$
じゅんぺー	ジュンペー	名サ形動*
じょ	ジョ	名サ形動*
じょっぴーが	ジョッピーガ	名詞サ変$
じょーだん	ジョーダン	名サ形動*
じょーだん	ジョーダン	名詞サ変*
じょーりぃ	ジョーリィ	名詞サ変$
じょい	ジョイ	名詞サ変$
じょうの	じょうの	名詞*
じょうのうち	城之内	名詞*
じょう゛ぃ	ジョヴィ	名サ形動*
じょじょ	ジョジョ	名サ形動*
じょじょ	ジョジョ	名詞サ変*
じょじょじ	ジョジョジ	名サ形動*
じょでぃふぉすたー	ジョディフォスター	名サ形動*
じょねす	ジョネス	名サ形動*
じょばー	ジョバー	名サ形動*
じょろきあ	ジョロキア	名詞サ変$
じょん	じょん	名詞サ変*
じょん	ジョン	名詞サ変*
じょんいる	ジョンイル	名サ形動*
じっけんさく	実験作	名詞*
じっさいちから	実際力	名詞*
じっしゃ	ジッシャ	名詞サ変*
じー	ジー	名詞サ変$
じーくんどー	ジークンドー	名詞サ変*
じーこ	ジーコ	名詞サ変*
じーにあす	ジーニアス	名サ形動*
じあんび	ジアンビ	名サ形動*
じえんど	ジエンド	名詞サ変*
じお	ジオ	名サ形動*
じおーる	ジオール	名詞サ変$
じおだいん	ジオダイン	名詞サ変*
じおん	ジオン	名サ形動*
じかどり	直取り	名詞サ変*
じかんしかね	時間しか寝	一段動詞$
じこくてん	ジコクテン	名詞サ変*
じじい	ジジイ	名詞サ変*
じじじじじ	ジジジジジ	名詞サ変*
じすかる	ジスカル	名詞サ変*
じせいだい	自制代	名詞*
じたん	ジタン	名詞サ変$
じだん	ジダン	名サ形動*
じつによいものだー	ｼﾞﾂﾆﾖｲﾓﾉﾀﾞｰ	名詞サ変*
じと	ジト	名詞サ変$
じのびり	ジノビリ	名サ形動*
じはーど	ジハード	名詞サ変*
じばく	ジバク	名詞サ変*
じぶり	ジブリ	名サ形動*
じぶり	ジブリ	名詞サ変$
じぶんたちのこと	自分たちの事	名詞$
じぶんでした	自分で舌	名詞*
じぶんのこと	自分の事	名詞*
じますたー	ジマスター	名サ形動*
じまん	ジマン	名サ形動*
じみへん	ジミヘン	名サ形動*
じむ	ジム	名詞サ変*
じる	ジル	名詞サ変*
じるおーる	ジルオール	名詞サ変*
じれい	地霊	名詞サ変*
じろーらも	ジローラモ	名サ形動*
じん	ジン	名詞サ変*
じんぎすかん	ジンギスかン	名詞サ変$
じんこうが	人口が	接続詞*
じんこうじたい	人口自体	名詞$
じんさん	ジンさん	名詞*
じんるーと	ジンルート	名詞サ変*
すぅー	スゥー	名詞サ変$
すっぞこら	スッゾコラ	名詞サ変$
すった	スッタ	名詞サ変$
すーぱー	スーパー	名詞サ変*
すーぱーぼうる	スーパーボウル	名サ形動*
すーぱーまりお	スーパーマリオ	名詞サ変*
すーふぁみ	スーファミ	名サ形動*
すーぺる	スーペル	名サ形動*
すいき	スイキ	名詞サ変*
すいぎんとう	水銀燈	名詞*
すいせいせき	翠星石	名詞*
すいとるため	吸い取るタメ	名サ形動$
すうぇーでん	スウェーデン	名詞サ変*
すうに	数２	数詞$
すかあ	スカア	名サ形動*
すかあは	スカアハ	名詞サ変*
すかでぃ	スカディ	名詞サ変*
すかとろ	スカトロ	名詞サ変$
すかとろと	スカトロト	名詞サ変$
すき	スキ	名サ形動*
すき	スキ	名詞サ変$
すきま	スキマ	名詞サ変$
すきる	スキル	名詞サ変*
すきるのため	スキルの為	名詞*
すきん	スキン	名詞サ変*
すぎぃ	スギィ	名詞サ変$
すくーぐすろー	スクーグスロー	名詞サ変*
すくうぇあ	スクウェア	名詞サ変*
すくえに	スクエニ	名詞サ変$
すくかじゃ	スクカジャ	名詞サ変*
すくと	スクト	名詞サ変*
すくりぷと	スクリプト	名詞サ変*
すくろーるばー	スクロールバー	名詞サ変*
すくんだ	スクンダ	名詞サ変*
すぐはや	すぐ流行	ラ行五段*
すけ	スケ	名サ形動*
すけいる	スケイル	名詞サ変*
すけきよ	スケキヨ	名詞サ変$
すけば	スケバ	名サ形動*
すけべ	スケベ	名詞サ変$
すげー	スゲー	名サ形動*
すこってぃ	スコッティ	名詞サ変$
すこーる	スコール	名詞サ変*
すこあ	スコア	名詞サ変*
すさのお	スサノオ	名詞サ変*
すさのおのみこと	スサノオノミコト	名詞サ変$
すざく	スザク	名詞サ変*
すし	スシ	名サ形動*
すし	スシ	名詞サ変*
すじ	スジ	名サ形動*
すすむ	ススム	名詞サ変$
すずへっど	ｽｽﾞﾍｯﾄﾞ	名詞サ変$
すた	スタ	名サ形動*
すたっふ	スタッフ	名詞サ変*
すたっふろーる	スタッフロール	名サ形動*
すたー	スター	名詞サ変*
すたーｓ	スターｓ	名詞*
すたーうぉーず	スターウォーズ	名サ形動*
すたーくらふと	スタークラフト	名詞サ変*
すたーせい	スター性	名詞*
すたーとあっぷ	スタートアップ	名詞サ変*
すたーぶ	スターブ	名サ形動*
すたーりん	スターリン	名詞サ変*
すたいる	スタイル	名詞サ変*
すたくら	スタクラ	名サ形動*
すたる	スタル	名詞サ変*
すだま	スダマ	名詞サ変*
すちゅわーです	スチュワーデス	名詞サ変*
すて	ステ	名サ形動*
すて	ステ	名詞サ変*
すてぃーな	スティーナ	名サ形動*
すてーきそーす	ステーキソース	名詞サ変*
すてま	ステマ	名詞サ変$
すてる	ステル	名詞サ変$
すてろいどはげ	ステロイドハゲ	名詞サ変$
すでの	州で野	名詞$
すと４	スト４	名詞サ変*
すとーり	ストーリ	名詞サ変*
すとーりー	ストーリー	名詞サ変*
すといこ	ストイコ	名詞サ変$
すとなーど	ストナード	名詞サ変*
すとらっくあうとｗ	ストラックアウトｗ	名詞サ変$
すとらでぃばり	ストラディバリ	名詞サ変*
すとりーと	ストリート	名詞サ変*
すとりーとふぁいたー	ストリートファイター	名サ形動*
すとりご	ストリゴ	名詞サ変*
すとれが	ストレガ	名サ形動*
すとれす	ストレス	名詞サ変*
すとれんじじゃーにー	ストレンジジャーニー	名詞サ変*
すとろべりーこーんず	ストロベリーコーンズ	名サ形動*
すなっちゃー	スナッチャー	名サ形動*
すにっかーず	スニッカーズ	名サ形動*
すにぺっと	スニペット	名詞サ変*
すね	巣根	名詞*
すね	スネ	名詞サ変*
すねーーく	スネーーク	名詞サ変*
すねーく	スネーク	名詞サ変*
すねお	スネオ	名サ形動*
すのーまん	スノーマン	名サ形動*
すばやさ	スバヤサ	名詞サ変*
すぱっつ	スパッツ	名詞サ変*
すぱいだーま	スパイダーマ	名詞サ変*
すぱいだーまん	スパイダーマン	名詞サ変*
すぱるた	スパルタ	名詞サ変*
すぱるな	スパルナ	名詞サ変*
すびーど	スビード	名詞サ変*
すぴーど	スピード	名詞サ変*
すぴーどてすと	スピードテスト	名サ形動*
すぴーどてすと	スピードテスト	名詞サ変*
すぴーどらん	スピードラン	名詞サ変*
すぴーどらんにんぐ	スピードランニング	名詞サ変$
すぴにゅるらー	ｽﾋﾟﾆｭﾙﾗｰ	名詞サ変$
すふぃあ	スフィア	名詞サ変$
すふぃんくす	スフィンクス	名詞サ変*
すぷー	スプー	名詞サ変*
すぷりがん	スプリガン	名詞サ変*
すぺっく	スペック	名詞サ変*
すぺーす	スペース	名詞サ変*
すぺつなず	スペツナズ	名詞サ変*
すぺるぶれーか	スペルブレーカ	名サ形動*
すぺるま	スペルマ	名詞サ変*
すぽんさー	スポンサー	名詞サ変*
すますま	スマスマ	名詞サ変*
すまふぉ	スマフォ	名詞サ変$
すみす	スミス	名詞サ変*
すめりー	スメリー	名詞サ変*
すもーくちーず	スモークチーズ	名詞サ変*
すらいむ	スライム	名詞サ変*
すらおしゃ	スラオシャ	名詞サ変*
すりがらす	スリガラス	名サ形動*
すりみ	スリミ	名サ形動*
すりらー	スリラー	名詞サ変*
すると	スルト	名詞サ変*
するのです	ｽﾙﾉﾃﾞｽ	名詞サ変*
すれ	スレ	名サ形動*
すれ	スレ	名詞サ変$
すれっがー	スレッガー	名サ形動*
すれい	スレイ	名詞サ変*
すれいぷにる	スレイプニル	名詞サ変*
すれどに	スレドニ	名詞サ変$
すわれ	ｽﾜﾚ	名詞サ変$
すん	すん	名詞サ変*
ずぇらろんず	ズェラロンズ	名詞サ変*
ずーる	ズール	名サ形動*
ずきゅーん	ズキューン	名詞サ変*
ずこばこーん	ｽﾞｺﾊﾞｺｰﾝ	名詞サ変*
ずり	ズリ	名サ形動*
せぇーくっす	セェークッス	名詞サ変$
せっくすあんどざしてぃ	セックスアンドザシティ	名サ形動*
せーがー	セーガー	名詞サ変*
せーぶでーた	セーブデータ	名サ形動*
せーぶでーた	セーブデータ	名詞サ変*
せーらーむーん	セーラームーン	名サ形動*
せいｆ	セイｆ	名詞*
せいいち	正位置	名詞サ変$
せいう゛ぁー	セイヴァー	名詞サ変$
せいおうぼ	セイオウボ	名詞サ変*
せいぎゅうかい	セイギュウカイ	名詞サ変*
せいこう	精講	名詞$
せいさん	成算	名詞サ変$
せいさんをかく	成算を欠く	名詞*
せいしゅく	セイシュク	名詞サ変$
せいしが	制止画	名詞$
せいじゅう	聖獣	名詞*
せいせい	セイセイ	名詞サ変*
せいていたいせい	セイテイタイセイ	名詞サ変*
せいてきな	性的菜	名詞$
せいてん	星天	名詞*
せいてん	正典	名詞*
せいてんたいせい	セイテンタイセイ	名詞サ変*
せいぬの	ｾｲﾇﾉ	名詞サ変$
せいばー	セイバー	名サ形動*
せいめいかん	生命感	名詞ザ変*
せいりゅう	セイリュウ	名詞サ変*
せえ	せえ	名詞サ変*
せかいかん	世界感	名詞ザ変*
せが	セガ	名詞サ変*
せきひ	石匙	名詞*
せくさろいど	セクサロイド	名サ形動*
せくさろいど	セクサロイド	名詞サ変*
せくろ	セクロ	名詞サ変*
せくろす	セクロス	名サ形動*
せくろす	セクロス	名詞サ変*
せぐめんてーた	セグメンテータ	名詞サ変*
せさーる	セサール	名詞サ変*
せそう	せそう	名詞サ変*
せたん	セタン	名サ形動*
せちひちすらかかに	セチヒチスラカカニ	名詞サ変*
せと	セト	名詞サ変*
せどな	セドナ	名詞サ変*
せばす	セバス	名詞サ変*
せふぃろす	セフィロス	名サ形動*
せふぃろす	セフィロス	名詞サ変*
せぶん	セブン	名詞サ変*
せまられること	迫られる事	名詞$
せみ	セミ	名詞サ変$
せみころん	セミコロン	名詞サ変*
せりあ	セリア	名サ形動*
せりえ	セリエ	名詞サ変*
せりふはや	台詞流行	ラ行五段*
せるしお	セルシオ	名詞サ変$
せるふ	セルフ	名詞サ変*
せれくた	セレクタ	名詞サ変$
せろにあす	セロニアス	名詞サ変$
せろにあすもんく	セロニアスモンク	名詞サ変$
せん	セン	名サ形動*
せんきゅう	扇弓	名詞*
せんしん	扇真	名詞*
せんせい	センセイ	名詞サ変$
せんせんしゃる	センセンシャル	名詞サ変$
せんたー	センター	名詞サ変*
せんてい	尖底	名詞$
せんとうご	戦闘後	名詞*
せんない	線内	接尾語*
せんぱい	センパイ	名サ形動*
せんり	センリ	名詞サ変*
ぜったー	ゼッター	名詞サ変$
ぜったい	ｾﾞｯﾀｲ	名詞*
ぜったい	ゼッタイ	名サ形動*
ぜったい	ゼッタイ	名詞サ変$
ぜつぼー	ゼツボー	名詞サ変$
ぜつぼーてき	ゼツボーテキ	名詞サ変$
ぜの	ゼノ	名詞サ変*
ぜのぎあす	ゼノギアス	名詞サ変*
ぜのさーが	ゼノサーガ	名詞サ変*
ぜるた	ゼルタ	名詞サ変*
ぜるだ	ゼルダ	名サ形動*
ぜれ	ゼレ	名詞サ変*
ぜろ	ｾﾞﾛ	名詞サ変$
ぜろよん	ゼロヨン	名サ形動*
ぜんいち	全一	固有人名$
ぜんたいてき	全体敵	名詞*
ぜんねん	ぜんねん	名詞*
ぜんべいおーぷん	ゼンベイオープン	名サ形動*
そっちけい	そっち系	名詞*
そーされす	ソーサレス	名サ形動*
そーす	ソース	名詞サ変*
そーせーじ	ソーセージ	名詞サ変$
そーだ	ソーダ	名詞サ変*
そーだやぁお	ｿｰﾀﾞﾔｧｵ	名詞サ変$
そーにゃ	ソーニャ	名詞サ変$
そーま	ソーマ	名詞サ変*
そーらん	ソーラン	名詞サ変*
そいみーと	ソイミート	名詞サ変*
そういうこと	そういう事	名詞*
そうえｎ	蒼炎	名詞*
そうえん	蒼炎	名詞サ変*
そうか	ソウカ	名詞サ変*
そうき	操気	名詞$
そうさくねがい	捜索願い	名詞サ変$
そうじろう	宗次郎	固有人名$
そうだや～	ソウダヤ～	名詞サ変$
そうびしたまえ	ｿｳﾋﾞｼﾀﾏｴ	名詞サ変$
そそ	祖祖	名詞*
そでこ	ソデコ	名詞サ変*
そとまよる	ソトマヨル	名サ形動*
そどむ	ソドム	名詞サ変*
そなー	ソナー	名詞サ変*
そに	ソニ	名詞サ変$
そにー	ソニー	名詞サ変*
そふと	そふと	名詞サ変*
そふと	ソフト	名詞サ変*
そふとそふと	ソフトソフト	名詞サ変*
そらりす	ソラリス	名詞サ変*
そらんす	ソランス	名詞サ変*
そるじゃー	ソルジャー	名詞サ変*
それいと	ソレイト	名詞サ変$
そろね	ソロネ	名詞サ変*
そん	ソン	名詞サ変$
そんごはん	孫悟飯	名詞*
そんし	尊士	固有人名$
そんな	ｿﾝﾅ	名詞サ変$
そんながら	そんな柄	名詞*
そんなめでみんなー	ｿﾝﾅﾒﾃﾞﾐﾝﾅｰ	名詞サ変$
そんび	ソンビ	名詞サ変$
ぞ	ゾ	名詞サ変$
ぞう	ゾウ	名詞サ変$
ぞうちょうてん	ゾウチョウテン	名詞サ変*
ぞうてい	ゾウテイ	名詞サ変$
ぞうていしよう	ゾウテイ仕様	名詞$
ぞるでぃっく	ゾルディック	名サ形動*
ぞん	ゾン	名サ形動*
たｋｋる	タｋｋル	名詞*
たｓ	ｔａｓ	名詞サ変$
たｓ	ﾀs	名詞サ変$
たった	勃った	名詞*
たー	ター	名詞サ変*
たーきんの	ターキンノ	名詞サ変$
たい	タイ	名詞サ変*
たいがーうっず	タイガーウッズ	名サ形動*
たいがーうっず	タイガーウッズ	名詞サ変*
たいがーきゃっぷ	タイガーキャップ	名詞サ変*
たいがーぐりーぶ	タイガーグリーブ	名詞サ変*
たいがーぐろーぶ	タイガーグローブ	名詞サ変*
たいがーじゃーきん	タイガージャーキン	名詞サ変*
たいしたこと	たいした事	名詞$
たいしたことないとい	たいしたことないと言	ワ行五段*
たいせんけい	対戦系	名詞*
たいそん	タイソン	名サ形動*
たいと	タイト	名詞サ変*
たいひょう	対氷	名詞*
たいぴいんぐ	タイピイング	名サ形動*
たいぷうぇる	タイプウェル	名サ形動*
たいぷうぇる	タイプウェル	名詞サ変*
たいほう	タイホウ	名詞サ変*
たいま	退魔	名詞*
たいまくん	大麻君	名詞$
たいむ	タイム	名詞サ変*
たいむすたんぷ	タイムスタンプ	名サ形動*
たいらー	タイラー	名詞サ変*
たいらんと	タイラント	名詞サ変*
たおすこと	倒す事	名詞$
たかかず	タカカズ	名サ形動*
たかさ	高差	名詞*
たかだきみひこ	タカダキミヒコ	名詞サ変*
たかだきみひこだよ	ﾀｶﾀﾞｷﾐﾋｺﾀﾞﾖ	名詞サ変*
たかや	タカヤ	名サ形動*
たきの	滝野	名詞*
たくてぃくす	タクティクス	名サ形動*
たくひ	タクヒ	名詞サ変*
たぐ・きー	タグ・キー	名詞サ変*
たけお	タケオ	名詞サ変*
たけみかづち	タケミカヅチ	名詞サ変*
たけみなかた	タケミナカタ	名詞サ変*
たける	タケル	名詞サ変$
たこ	タコ	名詞サ変*
たこやき	タコヤキ	名詞サ変*
たさく	太作	固有人名$
たさく	田作	固有人姓$
たさく	田作	固有人名$
たじり	タジリ	名詞サ変*
たたえるわけ	称える訳	名詞*
ただ	タダ	名詞サ変*
ただせん	ただ先	接頭語*
ただの	タダノ	名詞サ変*
ただのぶ	ただのぶ	名詞*
たち	タチ	名詞サ変$
たちうちでき	太刀打ち出来	一段動詞*
たちばなし	橘氏	名詞$
たつ	タツ	名詞サ変$
たつこと	立つ事	名詞$
たつの	龍野	名詞*
たてがみ	タテガミ	名詞サ変*
たとぅー	タトゥー	名詞サ変$
たにし	田仁志	固有人姓$
たにし	田仁志	名詞*
たぬき	タヌキ	名詞サ変$
たのか	たのか	名詞サ変*
たのかよ	たのかよ	名詞サ変*
たぶ	タブ	名詞サ変*
たぶばー	タブバー	名詞サ変*
たぶれっと	タブレット	名詞サ変*
たぶろいど	タブロイド	名詞サ変*
たぷる	タプル	名詞サ変*
たほうが	たほうが	名詞サ変*
たぼたぼ	タボタボ	名詞サ変*
たまこ	玉子	名詞*
たまこん	タマコン	名サ形動*
たまたま	タマタマ	名サ形動*
たみふる	タミフル	名サ形動*
たむけん	タムケン	名サ形動*
たむりん	タムリン	名詞サ変*
ため	タメ	名サ形動*
たもり	タモリ	名詞サ変*
たらっ	タラッ	名サ形動*
たりぼん	タリボン	名サ形動*
たるかじ	タルカジ	名詞サ変*
たるかじゃ	タルカジャ	名サ形動*
たるかじゃ	タルカジャ	名詞サ変*
たるたろす	タルタロス	名サ形動*
たるんだ	タルンダ	名詞サ変*
たわー	タワー	名詞サ変*
たわーしーるど	タワーシールド	名詞サ変*
たんいで	単位出	一段動詞$
たんがた	タンガタ	名詞サ変*
たんどりーちきん	タンドリーチキン	名詞サ変*
たんめん	タンメン	名詞サ変*
たんんい	タンンイ	名サ形動*
だっしゅつてい	脱出艇	名詞$
だっちわいふ	ダッチワイフ	名詞サ変*
だっぢんぐ	ダッヂング	名詞サ変*
だー	ダー	名サ形動*
だー	ﾀﾞｰ	名詞サ変$
だーきにー	ダーキニー	名詞サ変*
だーく	ダーク	名詞サ変*
だーくはんたー	ダークハンター	名詞サ変*
だーすもーる	ダースモール	名サ形動*
だーずべいだー	ダーズベイダー	名サ形動*
だーてぃ	ダーティ	名詞サ変*
だあ	だあ	名詞サ変*
だい	(代)	名詞*
だいあーうるふ	ダイアーウルフ	名詞サ変*
だいあな	ダイアナ	名詞サ変*
だいがくぶ	大学分	名詞*
だいこう	大銧	名詞*
だいこうが	大銧が	接続詞*
だいこうが	大黄河	名詞*
だいこうはん	台後半	名詞*
だいご	ダイゴ	名サ形動*
だいじなこと	大事な事	名詞*
だいぜん	大全	接頭語*
だいたん	大単	接頭語*
だいち	ダイチ	名詞サ変*
だいなまら	ダイナマラ	名詞サ変*
だいなみっく	だいなみっく	名詞サ変*
だいひょうに	代表似	一段動詞*
だいぶ	ダイブ	名サ形動*
だうと	ダウト	名サ形動*
だうんぜんと	ダウンゼント	名詞サ変*
だう゛ぃんち	ダヴィンチ	名詞サ変*
だからごみー	ダカラゴミー	名詞サ変$
だくしゃ	ダクシャ	名詞サ変$
だくそ	ダクソ	名詞サ変$
ださ	ダサ	名詞サ変*
ださい	ダサイ	名詞サ変*
ださいだけ	ダサイダケ	名詞サ変*
ださいのは	ださいのは	名詞サ変*
ださいん	ダサイン	名サ形動*
ださく	ださく	名詞サ変*
だせないこと	出せない事	名詞*
だだいずむ	ダダイズム	名詞サ変*
だてん	堕天	名詞*
だてんし	堕天使	名詞*
だてんし	堕天し	サ変動詞*
だふね	ダフネ	名詞サ変*
だぶり	ダブリ	名サ形動*
だぶるしょっと	ダブルショット	名詞サ変*
だぼだぼ	ダボダボ	名詞サ変*
だまってみ	黙って見	一段動詞*
だますかす	ダマスカス	名詞サ変*
だまと	ダマト	名詞サ変*
だめ	ﾀﾞﾒ	名詞*
だめ	ダメ	名詞サ変*
だめだめ	ダメダメ	名詞サ変$
だらだら	ダラダラ	名詞サ変$
だる	ダル	名詞サ変*
だるう゛ぃっしゅ	ダルヴィッシュ	名サ形動*
だるびっしゅ	ダルビッシュ	名サ形動*
だるびっしゅ	ダルビッシュ	名詞サ変$
だるま	ダルマ	名詞サ変*
だれ	ダレ	名詞サ変$
だれお	ダレオ	名詞サ変$
だろ	だろ	名詞サ変*
だんしんぐはんど	ダンシングハンド	名詞サ変$
だんじょん	ダンジョン	名サ形動*
だんせいてき	男性敵	名詞*
だんぜんあり	断然アリ	名詞サ変*
だんたりあん	ダンタリアン	名詞サ変*
だんて	ダンテ	名詞サ変*
だんばん	ダンバン	名詞サ変$
ちぇーんそー	チェーンソー	名詞サ変*
ちぇだー	チェダー	名サ形動*
ちぇん	チェン	名サ形動*
ちゃ	チャ	名サ形動*
ちゃー	チャー	名サ形動*
ちゃー	チャー	名詞サ変*
ちゃーけん	チャーケン	名サ形動*
ちゃーけん	チャー研	固有人姓*
ちゃーけん	チャー研	固有人名*
ちゃーじまん	チャージマン	名サ形動*
ちゃーじまん	チャージマン	名詞サ変*
ちゃーちる	チャーチル	名詞サ変*
ちゃーむでぃ	チャームディ	名詞サ変*
ちゃうせすく	チャウセスク	名サ形動*
ちゃくら	チャクラ	名詞サ変*
ちゃくらうゃーく	チャクラウャーク	名詞サ変*
ちゃげ	チャゲ	名サ形動*
ちゃな	チャナ	名サ形動*
ちゃび	チャビ	名詞サ変$
ちゃふう	茶風	名詞形動*
ちゃふうりん	茶風林	接尾語*
ちゃべす	チャベス	名サ形動*
ちゃべす	チャベス	名詞サ変*
ちゃんだん	チャンダン	名詞サ変$
ちゃんねる	チャンネル	名詞サ変$
ちゃんぷ	チャンプ	名詞サ変*
ちゅ	チュ	名詞サ変*
ちゅー	チュー	名詞サ変$
ちゅーとんないと	チュートンナイト	名詞サ変*
ちゅう	蟲	単漢字$
ちゅういりょく	中威力	名詞*
ちゅうけんしゃ	中堅者	名詞*
ちゅうに	中二	数詞*
ちゅうに	厨二	数詞*
ちゅうにびょう	中二病	名詞*
ちゅうにびょう	厨二秒	名詞$
ちゅうねんぶとり	中年ブトリ	名詞サ変*
ちゅうぼう	中坊	固有人姓$
ちゅにっく	チュニック	名詞サ変*
ちゅぱかぶら	チュパカブラ	名詞サ変*
ちゅれる	チュレル	名詞サ変*
ちょ	チョ	名サ形動*
ちょっと	チョット	名詞サ変$
ちょう	チョウ	名詞サ変$
ちょうこうこう	超高校	名詞$
ちょうこうこうきゅう	超高校級	名詞$
ちょうじ	兆治	名詞サ変*
ちょうせいすう	長整数	名詞*
ちょうたん	超単	接頭語*
ちょうのうりょくしゃ	超能力（社）	名詞*
ちょうのはね	蝶の羽	名詞*
ちょくと	チョクト	名詞サ変$
ちょこぼ	チョコボ	名サ形動*
ちょこぼーい	チョコボーイ	名詞サ変$
ちょとんだ	チョトンダ	名詞サ変*
ちょぴん	チョピン	名詞サ変*
ちょめちょめ	チョメチョメ	名詞サ変*
ちょろ	チョロ	名サ形動*
ちょろいかも	チョロいカモ	名詞サ変$
ちょろいん	チョロイン	名詞サ変$
ちょん	チョン	名サ形動*
ちっく	チック	名詞サ変*
ちーず	チーズ	名詞サ変*
ちーと	チート	名サ形動*
ちいさいこと	小さい事	名詞*
ちえ	チエ	名詞サ変$
ちかいところ	近い所	名詞*
ちかえ	近江	固有人姓$
ちかえ	近江	固有人名$
ちがいすぎ	違い過ぎ	一段動詞*
ちがく	ちがく	名詞サ変*
ちきんまさら	チキンマサラ	名詞サ変$
ちさと	チサト	名サ形動*
ちずる	千鶴	固有人名$
ちど	チド	名サ形動*
ちび	チビ	名詞サ変*
ちほ	値穂	名詞*
ちゆか	血床	名詞*
ちるとん	チルトン	名サ形動*
ちるの	チルノ	名サ形動*
ちるの	チルノ	名詞サ変*
ちろう	遅漏	名詞$
ちんかす	チンカス	名サ形動*
ちんこ	チンコ	名詞サ変*
ちんこ	ちんこ	名詞サ変$
ちんそうだん	珍走団	接尾語*
ちんそうだん	珍走団	名詞*
ちんちん	チンチン	名詞サ変*
ちんぴら	チンピラ	名詞サ変*
ちんぽ	チンポ	名サ形動*
ちんぽうあめ	珍宝飴	名詞*
ぢｓｋ	ディスク	名サ形動$
つぁらとぅすとぅら	ツァラトゥストゥラ	名詞サ変*
つぁると	ツァルト	名サ形動*
つぃつぃ	ツィツィ	名詞サ変*
つーか	つーか	名詞サ変*
つーる	ツール	名詞サ変*
つーるばー	ツールバー	名サ形動*
つーるばー	ツールバー	名詞サ変*
ついつい	ツイツイ	名詞サ変*
ついんて	ツインテ	名詞サ変$
つう゛ぁいん	ツヴァイン	名詞サ変*
つえ	ツエ	名詞サ変*
つかえるよう	使える用	名詞$
つかわせること	使わせる事	名詞$
つぎはぎ	ツギハギ	名詞サ変*
つくってるとき	作ってる時	名詞$
つくーる	ツクール	名サ形動*
つくーる	ツクール	名詞サ変*
つくること	作る事	名詞$
つくれるわけ	作れる訳	名詞$
つぐも	津雲	固有人姓$
つけてること	付けてる事	名詞$
つごいねる	ツゴイネル	名詞サ変*
つそ	ツソ	名詞サ変*
つつかな	ツツカナ	名詞サ変$
つばき	唾木	名詞$
つよいとき	強い時	名詞*
つよいところ	強い所	名詞$
つよいねー	ツヨイネー	名詞サ変*
つよし	ツヨシ	名詞サ変*
つら	ツラ	名サ形動*
つらゆき	貫之	固有人名$
つりー	ツリー	名詞サ変*
つる	ツル	名詞サ変*
つるき	釣る気	名詞$
つん	ツン	名詞サ変*
つんｄれ	ツンｄレ	名詞*
つんで	ツンデ	名サ形動*
つんでれ	ツンデレ	名詞サ変$
づら	ヅラ	名サ形動*
てｍぷら	テンプラ	名サ形動$
てぃっと	ティット	名詞サ変$
てぃあまと	ティアマト	名詞サ変*
てぃす	ティス	名サ形動*
てぃたーにあ	ティターニア	名詞サ変*
てぃたーん	ティターン	名詞サ変*
てぃと	ティト	名詞サ変*
てぃな	ティナ	名詞サ変*
てぃらえる	ティラエル	名詞サ変$
てぃらの	ティラノ	名サ形動*
てぃろ・ふぃなーれ	ティロ・フィナーレ	名詞サ変$
てーぶるまなー	テーブルマナー	名詞サ変*
てーま	テーマ	名詞サ変*
てーまぱーく	テーマパーク	名サ形動*
ていこうしない	抵抗市内	名詞$
ていこうでき	抵抗出来	一段動詞$
ていじん	テイジン	名サ形動*
ているす	テイルス	名詞サ変$
ておとめとる	テオトメトル	名詞サ変*
てききゃら	テキキャラ	名サ形動*
てききゃら	敵キャラ	名詞サ変*
てきすと	テキスト	名詞サ変*
てきだん	敵団	名詞*
てきとー	テキトー	名詞サ変*
てきな	てきな	名詞サ変$
てこ	テコ	名詞サ変$
てした	テシタ	名サ形動*
てすとぽりてか	テストポリテカ	名詞サ変*
てず	テズ	名サ形動*
てて	ｗｗ	名詞*
てて	テテ	名詞サ変*
ててて	ｗｗｗ	名詞*
ててて	テテテ	名サ形動*
てててて	ｗｗｗｗ	名詞*
てでぃべあ	テディベア	名サ形動*
てとらかーん	テトラカーン	名詞サ変*
てとらじゃ	テトラジャ	名詞サ変*
てとりす	テトリス	名詞サ変*
てに	テニ	名サ形動*
てにぬ	テニヌ	名詞サ変$
てにぷり	テニプリ	名サ形動*
てふら	テフラ	名詞サ変$
てへ	テヘ	名詞サ変$
てべす	テベス	名サ形動*
てぽどん	テポドン	名詞サ変*
てむ	テム	名サ形動*
てめぇ	テメェ	名サ形動*
てめー	テメー	名サ形動*
てら	テラ	名詞サ変*
てら	ﾃﾗ	名詞サ変*
てりあか	テリアカ	名詞サ変*
てれって	テレッテ	名サ形動*
てれってってってー	テレッテッテッテー	名サ形動*
てれってー	テレッテー	名サ形動*
てれび	テレビ	名詞サ変*
てれべ	テレベ	名サ形動*
てろ	テロ	名詞サ変*
てろす	テロス	名詞サ変*
てろてろ	テロテロ	名詞サ変*
てん	テン	名詞サ変*
てんしんはん	天津飯  	名詞*
てんてつ	天鉄	名詞*
てんぶん	点分	名詞*
てんぷれーと	テンプレート	名詞サ変*
てんぺすと	テンペスト	名詞サ変*
てんぽ	ﾃﾝﾎﾟ	名詞*
でぃーす	ディース	名詞サ変*
でぃーびー	ディービー	名サ形動*
でぃあ	ディア	名詞サ変*
でぃあぶろ	ディアブロ	名サ形動*
でぃあらはん	ディアラハン	名詞サ変*
でぃあらま	ディアラマ	名詞サ変*
でぃおにゅそす	ディオニュソス	名詞サ変*
でぃおにーじす	ディオニージス	名詞サ変$
でぃすかばりー	ディスカバリー	名詞サ変*
でぃすがいあ	ディスガイア	名サ形動*
でぃずにー	ディズニー	名詞サ変*
でぃの	ディノ	名詞サ変*
でぃふぇん	ディフェン	名詞サ変*
でぃぶく	ディブク	名詞サ変*
でぃまじお	ディマジオ	名サ形動*
でぃらの	ディラノ	名サ形動*
でぃれくたーずかっと	ディレクターズカット	名サ形動*
でぃん	ディン	名詞サ変*
でゅー	デュー	名詞サ変$
でゅある	デュアル	名詞サ変*
でゅらい	デュライ	名詞サ変*
でゅらん	デュラン	名サ形動*
でゅらん	デュラン	名詞サ変*
でっく	デック	名詞サ変*
でっでっ	デッデッ	名詞サ変$
でっでっでっでっ	デッデッデッデッ	名詞サ変$
でっでっどん	デッデッドン	名詞サ変$
でっどまん	デッドマン	名詞サ変$
でーじ	デージ	名詞サ変*
でーた	データ	名詞サ変*
でいず	デイズ	名詞サ変*
でいだら	デイダラ	名詞サ変$
でいびっと	デイビット	名詞サ変*
でう゛ぃっと	デヴィット	名サ形動*
でう゛ぃっど	デヴィッド	名詞サ変$
でう゛ゅー	デヴュー	名詞サ変*
でか	で書	カ行五段*
でかい	デカイ	名サ形動*
でかい	デカイ	名詞サ変*
でかいこと	デカイ事	名詞*
でかく	デカク	名サ形動*
でかさ	デカサ	名サ形動*
でかじゃ	デカジャ	名詞サ変*
でかちん	デカチン	名詞サ変$
でからびあ	デカラビア	名詞サ変*
でき	デキ	名サ形動*
でき	デキ	名詞サ変$
できないこと	できない事	名詞*
できないこと	出来ない事	名詞*
できる	デキル	名サ形動*
でくんだ	デクンダ	名詞サ変*
でこすけ	デコスケ	名詞サ変$
でこぽん	デコポン	名詞サ変*
でござる	デゴザル	名サ形動*
でざーと	デザート	名詞サ変*
です	デス	名サ形動*
です	デス	名詞サ変*
ですく	デスク	名詞サ変*
ですすとーかー	デスストーカー	名詞サ変$
ですと	デスト	名サ形動*
ですとろい	デストロイ	名サ形動*
ですばうんど	デスバウンド	名詞サ変*
ですぼいす	デスボイス	名詞サ変$
でてくれたこと	出てくれた事	名詞*
ででで	デデデ	名サ形動*
ででどん	デデドン	名詞サ変$
でにーろ	デニーロ	名詞サ変*
でびゅ	デビュ	名サ形動*
でびっと・ぼうい	デビット・ボウイ	名サ形動*
でびっとりんち	デビットリンチ	名詞サ変*
でびさば	デビサバ	名詞サ変*
でびど	デビド	名詞サ変$
でびる	デビル	名詞サ変*
でびるさばいばー	デビルサバイバー	名詞サ変*
でふぉ	デフォ	名サ形動*
でふぉ	デフォ	名詞サ変*
でふぉると	デフォルト	名詞サ変*
でぶ	デブ	名詞サ変*
でぶか	デブ化	名詞サ変$
でぺっしゅ	デペッシュ	名詞サ変$
でぺっしゅ・もーど	デペッシュ・モード	名詞サ変$
でもんじゃーきん	デモンジャーキン	名詞サ変*
でもんず	デモンズ	名詞サ変*
でもんずそうる	デモンズソウル	名詞サ変$
でら	デラ	名サ形動*
でら	デラ	名詞サ変*
でり・へる	デリ・ヘル	名詞サ変*
でる	デル	名サ形動*
でるぴえろ	デルピエロ	名サ形動*
でるふあいなす	デルフアイナス	名詞サ変*
でれ	デレ	名サ形動*
でれたー	デレター	名サ形動*
でれます	デレマス	名詞サ変*
でろりあん	デロリアン	名詞サ変$
でん	デン	名サ形動*
でんぜる	デンゼル	名サ形動*
でんとうてっき	デントウテッキ	名詞サ変*
でんのう	電王	名詞$
でんのうせん	電王戦	名詞サ変$
でんぷしー	デンプシー	名サ形動*
とぅー	トゥー	名詞サ変*
とぅらんがりら	トゥランガリラ	名詞サ変$
とぅるー	トゥルー	名詞サ変*
とぅんとぅく	トゥントゥク	名詞サ変*
とってぃ	トッティ	名サ形動*
とってぃ	トッティ	名詞サ変*
とーと	トート	名詞サ変*
とーとー	トートー	名詞サ変*
とーのふ	トーノフ	名サ形動*
とーます	トーマス	名詞サ変*
とーる	トール	名詞サ変*
とうえき	糖液	名詞$
とうきょうこうか	東京工科	名詞$
とうしょうめん	刀削麺	名詞*
とうしん	東進	名詞$
とうだい	塔第	冠数詞$
とうてつ	トウテツ	名詞サ変*
とうほうしんじゃ	東方信者	名詞*
とうりゅう	豆粒	名詞$
とうりゅうもん	豆粒文	接尾語$
とおえ	遠江	固有人姓$
とおの	トオノ	名詞サ変$
とおのふぉん	トオノフォン	名詞サ変$
とおる	トオル	名詞サ変$
とかい	とか言	ワ行五段*
とがい	トガイ	名サ形動*
ときおか	時オカ	名詞サ変*
ときざね	トキザネ	名詞サ変$
ときどきめをはなすのです	ﾄｷﾄﾞｷﾒｦﾊﾅｽﾉﾃﾞｽ	名詞サ変*
とくがわ	トクガワ	名サ形動*
とくしゅし	特殊市	名詞*
とくていでき	特定出来	一段動詞*
とぐろ	トグロ	名サ形動*
とぐろ	戸愚呂	名詞*
とけてき	解けて来	カ変動詞*
とげ	トゲ	名詞サ変*
とこみ	常見	固有人姓$
とさつ	屠殺	名詞*
とと	トト	名サ形動*
ととのったからだ	整った体	名詞*
となてぃわ	トナティワ	名詞サ変*
とぱんが	トパンガ	名詞サ変$
とぼそ	枢	単漢字$
とまと	トマト	名詞サ変$
とみの	トミノ	名サ形動*
とむ	トム	名詞サ変$
とめたぼ	トメタボ	名サ形動*
ともこ	トモコ	名詞サ変*
とらいあうと	トライアウト	名詞サ変*
とらいあすろｎ	トライアスロｎ	名詞サ変*
とらえること	とらえる事	名詞*
とらがわ	虎皮	名詞*
とらそるておとる	トラソルテオトル	名詞サ変*
とらるてくとり	トラルテクトリ	名詞サ変*
とらろっく	トラロック	名詞サ変*
とらんくす	トランクス	名詞サ変*
とらんす	トランス	名詞サ変*
とらんすついんず	トランスツインズ	名詞サ変$
とらんぺったー	トランペッター	名詞サ変*
とりっきー	トリッキー	名詞サ変*
とりっきーだんす	トリッキーダンス	名詞サ変*
とりっくすてっぷ	トリックステップ	名詞サ変*
とりある	とりある	名詞*
とりすあぎおん	トリスアギオン	名詞サ変*
とりだす	トリダス	名詞サ変*
とりや	取り屋	接尾語*
とるねーど	トルネード	名詞サ変*
とるのです	ﾄﾙﾉﾃﾞｽ	名詞サ変*
とるのです	トルノデス	名詞サ変*
とるわけ	取る訳	名詞$
とれーにんぐ	とれーにんぐ	名詞サ変*
とれす	トレス	名詞サ変*
とれん	とレン	名詞サ変*
とれんと	トレント	名詞サ変$
とろ	トロ	名詞サ変$
とろい	トロイ	名詞サ変*
とんでもないこと	とんでもない事	名詞$
とんぱ	トンパ	名サ形動*
どぅー	ドゥー	名詞サ変*
どぅーくー	ドゥークー	名サ形動*
どっか	ドッカ	名サ形動*
どっぢ	ドッヂ	名詞サ変*
どっと	ドット	名詞サ変*
どーべるまん	ドーベルマン	名詞サ変$
どーむ	ドーム	名詞サ変*
どーる	ﾄﾞｰﾙ	名詞*
どあ	ドア	名詞サ変*
どいつご	ドイツ御	接頭語*
どいつご	ドイツ語	名詞*
どうぇるぐの	ドウェルグノ	名詞サ変*
どうせいあい	同姓愛	名詞サ変*
どうとくてき	道徳敵	名詞*
どかた	土方	名詞*
どかぽん	ドカポン	名詞サ変*
どく	ドク	名詞サ変*
どくばり	ドクバリ	名詞サ変*
どころが	どころ蛾	名詞*
どしゅうじ	ﾄﾞｼｭｳｼﾞ	名詞サ変$
どすけべびっち	ドスケベビッチ	名詞サ変$
どすどすどす	ドスドスドス	名詞サ変*
どすぱら	ドスパラ	名詞サ変*
どちんぽ	ドチンポ	名詞サ変$
どどん	ドドン	名詞サ変$
どどんぱち	怒首領蜂	名詞*
どな	ドナ	名詞サ変*
どねあ	ドネア	名詞サ変$
どふとえふすきー	ドフトエフスキー	名詞サ変*
どふりー	ドフリー	名サ形動*
どま	ドマ	名サ形動*
どみにおん	ドミニオン	名詞サ変*
どめ	ドメ	名サ形動*
どら	ドラ	名サ形動*
どらっぐおん	ドラッグオン	名詞サ変$
どらっぐおんどらぐーん	ドラッグオンドラグーン	名詞サ変$
どらいば	ドライバ	名詞サ変*
どらくえ	ドラクエ	名詞サ変*
どらくえも	ドラクエモ	名サ形動*
どらごそ	ドラゴソ	名詞サ変*
どらごん	ドラゴン	名詞サ変*
どらごんくぉーたー	ドラゴンクォーター	名詞サ変$
どらごんぼー	ドラゴンボー	名詞サ変*
どらごんぼーる	ドラゴンボール	名詞サ変*
どりーむきゃすと	ドリームキャスト	名サ形動*
どりーむまっち	ドリームマッチ	名詞サ変$
どりくら	ドリクラ	名詞サ変*
どるみなー	ドルミナー	名詞サ変*
どれっしんぐ	ドレッシング	名詞サ変*
どろてーあ	ドロテーア	名詞サ変$
どわーふ	ドワーフ	名詞サ変*
どんきー	ドンキー	名詞サ変*
どんたく	ドンタク	名詞サ変*
どんどん	ドンドン	名詞サ変*
なっく	ナック	名詞サ変$
なっくる	ナックル	名詞サ変*
なーが	ナーガ	名詞サ変*
なーしゃ	ナーシャ	名詞サ変$
なーじゃ	ナージャ	名サ形動*
なーど	ナード	名サ形動*
ないき	ナイキ	名詞サ変*
ないしょう	ない賞	名詞サ変$
ないす	ナイス	名詞サ変*
ないせいてき	無い性的	名詞形動*
ないと	ナイト	名詞サ変$
ないとでき	ないと出来	一段動詞$
ないひと	ない人	名詞*
ないふ	ナイフ	名詞サ変*
なうい	ナウイ	名詞サ変*
なういｓ	ナウイｓ	名詞*
なうしか	ナウシカ	名詞サ変$
なうまんぞう	ナウマンゾウ	名詞サ変$
なう゛ぃ	ナヴィ	名サ形動*
なお	奈央	固有人名*
なお	菜牡	名詞*
なお	菜央	名詞*
なおすこと	直す事	名詞*
なおと	直斗	固有人名$
なおや	ナオヤ	名詞サ変*
なかお	な顔	名詞サ変*
なかた	ナカタ	名サ形動*
なかだし	中出し	名詞*
なきたい	な期待	名詞サ変*
なぐ	ナグ	名詞サ変*
なぐら	ナグラ	名サ形動*
なぐらい	名倉イ	名詞サ変$
なけ	なけ	名詞サ変*
なこう	な甲	名詞*
なこと	な事	名詞$
なしょじお	ナショジオ	名詞サ変*
なしょなる	ナショナル	名詞サ変*
なじき	な時期	名詞*
なせ	ナセ	名サ形動*
なたたいし	ナタタイシ	名詞サ変$
なだこう	灘校	名詞$
なだる	ナダル	名サ形動*
なだる	ナダル	名詞サ変*
なち	ナチ	名詞サ変$
なちす	ナチス	名詞サ変*
なづき	菜月	名詞$
なとこ	なとこ	名詞サ変*
なとす	ナトス	名サ形動*
ななか	な中	名詞*
ななめせん	斜め線	名詞*
なに	ナニ	名詞サ変*
なの	ナノ	名詞サ変$
なはなは	ナハナハ	名詞サ変$
なぶき	な武器	名詞*
なぽり	ナポリ	名詞サ変*
なぽれおん	ナポレオン	名詞サ変*
なみ	南	単漢字*
なみだで	涙出	一段動詞$
なむこみゅーじあむ	ナムコミュージアム	名サ形動*
なめられる	ナメラレル	名詞サ変*
なゆた	那由他	名詞*
なよ	ナヨ	名詞サ変$
ならんちゃ	ナランチャ	名詞サ変$
なり	ナリ	名サ形動*
なり	ナリ	名詞サ変$
なりたつわけ	成り立つ訳	名詞*
なる	ナル	名サ形動*
なる	ナル	名詞サ変*
なるかみ	ナルカミ	名サ形動*
なるじゃ	ナルジャ	名サ形動*
なると	ナルト	名サ形動*
なると	ナルト	名詞サ変*
なるとす	ナルトス	名詞サ変*
なるみ	ナルミ	名詞サ変$
なれ	ナレ	名詞サ変$
なん	ナン	名サ形動*
なん	ナン	名詞サ変*
なんけい	難系	名詞$
なんだってー	ナンダッテー	名詞サ変*
なんてい	何て言	ワ行五段$
なんで	ナンデ	名詞サ変$
なんで	ﾅﾝﾃﾞ	名詞サ変$
なんば	ナンバ	名詞サ変*
なんぼ	ナンボ	名詞サ変*
にゃ	ニャ	名詞サ変$
にゃる	ニャル	名サ形動*
にゃるの	ニャルノ	名詞サ変*
にゃんこ	ニャンコ	名詞サ変$
にゅー	ニュー	名詞サ変*
にゅーとりかる	ニュートリカル	名詞サ変*
にゅーよーく	ニューヨーク	名詞サ変*
にゅくす	ニュクス	名サ形動*
にょ	ニョ	名サ形動*
にっちろー	ニッチロー	名詞サ変$
にっぺ	ニッペ	名詞サ変*
にっぽん	ニッポン	名詞サ変$
にーっぺ	ニーッペ	名詞サ変*
にーすほっぐ	ニースホッグ	名詞サ変*
にーと	ニート	名詞サ変*
にあわせて	にあわせて	名詞サ変*
にあん	ニアン	名詞サ変$
にい	に位	名詞*
にい	二慰	名詞*
にいけ	にいけ	名詞サ変*
にかい	2回	名詞サ変$
にが	ニガ	名詞サ変*
にぎみたま	ニギミタマ	名詞サ変*
にく	ニク	名詞サ変$
にこ	ニコ	名サ形動*
にこ	ニコ	名詞サ変*
にこにこ	ニコニコ	名詞サ変*
にこにこどうが	ニコニコ動画	名詞*
にこぱれーど	ニコパレード	名サ形動*
にし	にし	サ変動詞$
にしおか	ニシオカ	名詞サ変*
にしきおり	錦織	名詞*
にしこり	錦織	名詞*
にしこり	にしこり	名詞*
にしのしょう	西野摺	名詞*
にすね	ニス根	名詞*
にた	に立	タ行五段*
にたようなこと	似たような事	名詞*
にだ	ニダ	名詞サ変*
にだ	に出	サ行五段*
にだなんて	ニダなんて	名詞サ変*
にちぶつ	ニチブツ	名サ形動*
にてん	似てん	名詞*
にとりこめる	にとりこめる	名詞*
にな	にな	名詞サ変*
になうこと	担う事	名詞$
には	ニハ	名詞サ変*
にはい	似敗	名詞サ変*
にぶつ	二物	名詞*
にへこへこ	にへこへこ	名詞*
にぺるそな	ニペルソナ	名サ形動*
にほん	にほん	名詞*
にほん	に本	名詞*
にほん	2本	名詞*
にもんく	に文句	名詞*
にる	ニル	名詞サ変*
にわ	ニワ	名サ形動*
にわか	ニワカ	名サ形動*
にんきで	人気出	一段動詞*
にんきな	人気な	形容詞*
にんげん	ニンゲン	名詞サ変*
にんげんにと	人間に取	ラ行五段*
にんじゃ	ニンジャ	名サ形動*
にんじゃ	ニンジャ	名詞サ変*
にんじゃなんで	ニンジャナンデ	名詞サ変$
にんじゃなんで	ﾆﾝｼﾞｬﾅﾝﾃﾞ	名詞サ変$
にんたいや	ニンタイヤ	名サ形動*
にんてん	ニンテン	名サ形動*
にんてん	ニンテン	名詞サ変$
ぬ	！	名詞*
ぬーく	ヌーク	名詞サ変$
ぬえ	ヌエ	名詞サ変*
ぬぎゃ０	ヌギャ０	名詞サ変*
ぬぎゃー	ヌギャー	名詞サ変*
ぬすんだもの	盗んだ物	名詞$
ぬる	ヌル	名詞サ変*
ぬるげー	ヌルゲー	名詞サ変$
ぬろっか	塗ろっか	名詞*
ねっきー	ネッキー	名詞サ変$
ねった	ネッタ	名詞サ変$
ねっと	ネット	名詞サ変*
ねっぷう	ネップウ	名詞サ変$
ねーむ	ネーム	名詞サ変*
ねい	ネイ	名詞サ変*
ねいさん	ネイサン	名サ形動*
ねいちゃー	ネイチャー	名詞サ変*
ねいね	根稲	名詞*
ねうろい	ネウロイ	名詞サ変*
ねお	ネオ	名詞サ変*
ねが	ネガ	名詞サ変$
ねがきゃん	ネガキャン	名詞サ変$
ねき	ネキ	名詞サ変$
ねくたる	ネクタル	名詞サ変*
ねこ	ネコ	名詞サ変*
ねこばば	ネコババ	名詞サ変*
ねこまた	ネコマタ	名詞サ変*
ねこめ	猫目	名詞*
ねた	ネタ	名詞サ変*
ねたふり	ネタふり	名詞サ変*
ねたも	ネタモ	名サ形動*
ねてろ	ネテロ	名サ形動*
ねとほも	ネトホモ	名詞サ変$
ねのね	値の根	名詞*
ねふぇるぴとー	ネフェルピトー	名詞サ変$
ねぼけたこと	寝ぼけた事	名詞$
ねみっさ	ネミッサ	名詞サ変*
ねむ	ネム	名サ形動*
ねらわれるくら	狙われる暗	形容詞$
ねりね	ネリネ	名詞サ変$
ねるがる	ネルガル	名詞サ変*
ねろ	ネロ	名詞サ変*
ねんね	年値	名詞*
のっかー	ノッカー	名詞サ変*
のってる	ノッテル	名サ形動*
のー	ノー	名詞サ変*
のーしょっと	ノーショット	名詞サ変*
のーぱそ	ノーパソ	名サ形動*
のーまる	ノーマル	名詞サ変*
のーむ	ノーム	名詞サ変*
のーら	ノーラ	名サ形動*
のーらん	ノーラン	名詞サ変*
のいえ	の家	名詞*
のいろ	の色	名詞*
のうけ	の受け	名詞サ変*
のうちの	のうちの	名詞サ変*
のうで	の腕	名詞*
のえきすとら	ノエキストラ	名サ形動*
のかみ	のかみ	名詞サ変*
のかみ	の神	名詞*
のきも	のキモ	名サ形動*
のくと	ノクト	名詞サ変$
のくに	の国	名詞*
のげ	ノゲ	名サ形動*
のげいら	ノゲイラ	名サ形動*
のこのこ	ノコノコ	名サ形動*
のこらないわけ	残らない訳	名詞*
のさき	の先	名詞$
のし	の死	名詞*
のし	ﾉｼ	名詞サ変$
のしあがってき	のし上がって来	カ変動詞$
のしつ	の質	名詞*
のしろ	の城	名詞$
のじゃんる	ノジャンル	名サ形動*
のすたー	ノスター	名サ形動*
のすたー	のすたー	名詞サ変*
のすとらだむす	ノストラダムス	名詞サ変*
のずち	ノズチ	名詞サ変*
のせいで	のせいで	名詞サ変*
のそう	の層	名詞*
のちから	の力	名詞*
のてんし	の天使	名詞*
のなか	のなか	名詞*
のはら	の腹	名詞*
のばか	のばか	名詞サ変*
のばとる	ノバトル	名サ形動*
のぶこ	ノブ子	名詞$
のべる	ノベル	名詞サ変*
のぼってい	上って言	ワ行五段*
のみず	の水	名詞$
のむら	のむら	名詞*
のむりっしゅ	ノムリッシュ	名詞サ変$
のもとで	のもとで	名詞サ変*
のもの	の物	名詞*
のり	ノリ	名詞サ変*
のりまさ	ノリマサ	名詞サ変$
のるど	ノルド	名詞サ変$
のるん	ノルン	名詞サ変*
のわーど	ノワード	名詞サ変*
のんけ	ノンケ	名サ形動*
のんけ	ノンケ	名詞サ変*
はぁはぁ	ﾊｧﾊｧ	名詞*
はっ	ハッ	名詞サ変*
はっかー	ハッカー	名詞サ変*
はっかーず	ハッカーズ	名詞サ変*
はっこうえき	発光駅	名詞$
はっしょくさえ	八色紗英	固有人名*
はっしー	ハッシー	名サ形動*
はっせる	ハッセル	名サ形動*
はっせるぶるく	ハッセルブルク	名サ形動*
はっせん	はっせん	名詞*
はってん	ハッテン	名サ形動*
はっとり	ハットリ	名詞サ変$
はっとりくん	ハットリ君	名詞$
はっとん	ハットン	名詞サ変*
はー	ハー	名サ形動*
はー	ハー	名詞サ変$
はーい	ハーイ	名詞サ変*
はーいｗ	ハーイｗ	名詞サ変*
はーいった	ハーイッタ	名詞サ変*
はーと	?	単漢字$
はーと	ハート	名詞サ変$
はーとしゅーたー	ハートシューター	名詞サ変*
はーどうぇあ	ハードウェア	名詞サ変*
はーどりちか	ハードリチカ	名サ形動*
はーぴー	ハーピー	名詞サ変*
はーふ	ハー負	名詞*
はーふ	ハーフ	名詞サ変*
はーふらいふ	ハーフライフ	名詞サ変*
はーぶ	ハーブ	名詞サ変*
はーもにっくとらすと	ハーモニックトラスト	名詞サ変*
はーんず	ハーンズ	名詞サ変*
はい	ハイ	名詞サ変*
はいから	ハイカラ	名詞サ変$
はいきっく	ハイキック	名サ形動*
はいそ	ハイソ	名詞サ変$
はいと	ハイト	名詞サ変*
はいど	ハイド	名詞サ変*
はいぱーくれいじーくらいまー	ハイパークレイジークライマー	名サ形動*
はいぱーよーよー	ハイパーヨーヨー	名詞サ変*
はいぱーりう゛ぁーしおん	ハイパーリヴァーシオン	名サ形動*
はいびすかす	ハイビスカス	名詞サ変*
はいぴくしー	ハイピクシー	名詞サ変*
はいふぇっつ	ハイフェッツ	名詞サ変*
はいぶ	ハイブ	名詞サ変*
はいぶーすた	ハイブースタ	名詞サ変*
はいらいと	ハイライト	名詞サ変*
はいる	ハイル	名サ形動*
はいれつ	ハイレツ	名詞サ変*
はいんつ	ハインツ	名詞サ変$
はうる	ハウル	名サ形動*
はおま	ハオマ	名詞サ変*
はがし	羽賀氏	名詞$
はがれん	ハガレン	名詞サ変*
はく	ハク	名サ形動*
はく	ハク	名詞サ変$
はくおう	薄桜	名詞$
はくじょうし	ハクジョウシ	名詞サ変*
はぐらー	ハグラー	名サ形動*
はぐらー	ハグラー	名詞サ変*
はけん	ハケン	名サ形動*
はげ	ハゲ	名サ形動*
はげ	ハゲ	名詞サ変*
はげちび	ハゲチビ	名詞サ変$
はこの	派この	連体詞$
はざ	ハザ	名サ形動*
はざーど	ハザード	名詞サ変*
はしふぇっつ	ハシフェッツ	名詞サ変*
はしま	はし魔	名詞*
はじまりは	ﾊｼﾞﾏﾘﾊ	名詞サ変$
はじまりはぜろ	ﾊｼﾞﾏﾘﾊｾﾞﾛ	名詞サ変$
はじめてあ	初めて会	ワ行五段*
はじめてみ	初めて見	一段動詞*
はたの	波田野	名詞*
はだめ	はだめ	名詞サ変*
はちまん	ハチマン	名詞サ変*
はちわんだいばー	ハチワンダイバー	名詞サ変$
はつぷれい	はつぷれい	名詞*
はとー	ハトー	名サ形動*
はとほる	ハトホル	名サ形動*
はとほる	ハトホル	名詞サ変*
はとぽっぽ	ハトポッポ	名詞サ変$
はなしおわ	話終わ	ラ行五段*
はにえる	ハニエル	名詞サ変*
はにかみ	ハニカミ	名サ形動*
はぬまーん	ハヌマーン	名詞サ変*
ははは	ハハハ	名サ形動*
はははは	ﾊﾊﾊﾊ	名詞サ変$
はぴーなうー	ハピーナウー	名詞サ変*
はぶ	ハブ	名詞サ変$
はべ	歯部	名詞*
はべつ	は別	名詞形動*
はま	破魔	名詞*
はま	ハマ	名詞サ変*
はまーん	ハマーン	名サ形動*
はまーん	ハマーン	名詞サ変*
はまお	ハマオ	名詞サ変*
はまおぷらいむ	ハマオプライム	名詞サ変*
はまおん	ハマオン	名詞サ変*
はまじで	はまじで	名詞サ変*
はまちゃん	浜ちゃん	名詞*
はまはま	ハマハマ	名サ形動*
はむ	ハム	名詞サ変$
はめ	ハメ	名サ形動*
はめ	ハメ	名詞サ変*
はめいす	ハメイス	名サ形動*
はめごろし	ハメ殺し	名詞サ変*
はめど	ハメド	名サ形動*
はめど	ハメド	名詞サ変*
はら	ハラ	名詞サ変*
はらいね	祓い根	名詞*
はらき	腹切	ラ行五段*
はらこや	原小屋	名詞*
はらす	ハラス	名サ形動*
はらす	ハラス	名詞サ変*
はらはあ	ハラハア	名サ形動*
はらはら	ハラハラ	名詞サ変*
はらわた	ハラワタ	名詞サ変*
はりー・ぽったー	ハリー・ポッター	名詞サ変*
はりうっほ	ハリウッホ	名サ形動*
はりてぃー	ハリティー	名詞サ変*
はりは	ハリハ	名サ形動*
はる	ハル	名詞サ変*
はるさん	ハルさん	名詞*
はるちゃん	春ちゃん	名詞$
はるばーど	ハルバード	名詞サ変*
はるぱす	ハルパス	名詞サ変*
はるひ	ハルヒ	名詞サ変*
はんか	半跏	名詞*
はんぐる	ハングル	名詞サ変*
はんげんぱつは	反原発派	名詞$
はんこ	ハンコ	名詞サ変$
はんごんこう	反魂香	名詞*
はんさ	ハンサ	名詞サ変*
はんさいくろぺでぃあ	ハンサイクロペディア	名詞サ変$
はんそく	ハンソク	名サ形動*
はんぞう	ハンゾウ	名詞サ変$
はんた	ハンタ	名詞サ変$
はんたー	ハンター	名詞サ変*
はんたーはんたー	ハンターハンター	名サ形動*
はんたーはんたー	ハンターハンター	名詞サ変*
はんたーらいむ	ハンターライム	名サ形動*
はんだー	ハンダー	名詞サ変$
はんちゅう	反中	名詞$
はんで	ハンデ	名詞サ変$
はんとれす	ハントレス	名サ形動*
はんな	ハンナ	名詞サ変*
はんりゅう	半龍	名詞$
ばっくべあーど	バックベアード	名サ形動*
ばっじょ	バッジョ	名詞サ変*
ばっち	バッチ	名詞サ変*
ばっと	バット	名詞サ変$
ばっふぁーろーまん	バッファーローマン	名サ形動*
ばっふあ	バッフア	名詞サ変*
ばー	バー	名詞サ変*
ばーか	バーカ	名詞サ変*
ばーさーかー	バーサーカー	名詞サ変*
ばーなーき	バーナーキ	名詞サ変$
ばーばりあん	バーバリアン	名詞サ変*
ばーらんだー	バーランダー	名詞サ変$
ばーん	バーン	名詞サ変*
ばい	バイ	名詞サ変*
ばいえるん	バイエルン	名詞サ変$
ばいお	バイオ	名詞サ変*
ばいおはざーと	バイオハザート	名サ形動*
ばいおはざーど	バイオハザード	名サ形動*
ばいつ	バイツ	名サ形動*
ばいつぁ	バイツァ	名サ形動*
ばいとこんぱいる	バイトコンパイル	名詞サ変*
ばいなり	バイナリ	名詞サ変*
ばか	バカ	名詞サ変*
ばかうけ	バカウケ	名詞サ変*
ばかうれ	ばかうれ	名詞*
ばかうれ	馬鹿売れ	一段動詞*
ばかす	バカス	名サ形動*
ばかてすＩ	バカテスＩ	名詞サ変$
ばかなところ	馬鹿な所	名詞*
ばかぶー	バカブー	名詞サ変*
ばかやろう	バカヤロウ	名詞サ変*
ばかろう	バカロウ	名詞サ変*
ばがぶー	バガブー	名詞サ変*
ばがぼんど	バガボンド	名詞サ変$
ばき	バキ	名サ形動*
ばき	バキ	名詞サ変*
ばくえん	爆炎	名詞*
ばくちく	バクチク	名詞サ変$
ばぐ	バグ	名詞サ変$
ばぐわむ	バグワム	名詞サ変$
ばざると	バザルト	名詞サ変$
ばしーる	バシール	名詞サ変*
ばしりすく	バシリスク	名詞サ変*
ばじりすく	バジリスク	名詞サ変*
ばす	バス	名詞サ変*
ばすがでるでー	ﾊﾞｽｶﾞﾃﾞﾙﾃﾞｰ	名詞サ変$
ばすたー	バスター	名詞サ変*
ばすたーどそーと゜	バスタードソート゜	名詞サ変*
ばた	バタ	名サ形動*
ばた	バタ	名詞サ変$
ばだはり	バダハリ	名詞サ変*
ばち	バチ	名サ形動*
ばてぃ	バティ	名サ形動*
ばてん	バテン	名詞サ変$
ばてんかいとす	バテンカイトス	名詞サ変$
ばでぃ	バディ	名サ形動*
ばと	バト	名詞サ変*
ばとー	バトー	名詞サ変$
ばとら	バトラ	名詞サ変*
ばとらー	バトラー	名詞サ変*
ばとりちぇふ	バトリチェフ	名詞サ変$
ばとる	バトル	名詞サ変*
ばとるどーむ	バトルドーム	名詞サ変*
ばとろわ	バトロワ	名詞サ変$
ばない	場内	接尾語$
ばね	バネ	名詞サ変*
ばばあ	ババア	名サ形動*
ばびぶべぼ	バビブベボ	名詞サ変*
ばふぉめっと	バフォメット	名詞サ変*
ばらされる	バラサレル	名サ形動*
ばらの	バラノ	名詞サ変*
ばらばら	バラバラ	名詞サ変*
ばらんす	バランス	名詞サ変*
ばりゅーせっと	バリューセット	名サ形動*
ばりはけん	バリハケン	名詞サ変$
ばりば	バリバ	名サ形動*
ばりばり	バリバリ	名詞サ変$
ばる	バル	名サ形動*
ばるす	バルス	名サ形動*
ばるど	バルド	名詞サ変$
ばるどる	バルドル	名詞サ変*
ばるどるば	バルドルバ	名詞サ変*
ばるばろっさ	バルバロッサ	名詞サ変$
ばれ	バレ	名詞サ変*
ばれら	バレラ	名サ形動*
ばれら	バレラ	名詞サ変*
ばれりーな	バレリーナ	名詞サ変*
ばれる	バレる	名詞*
ばれろ	バレロ	名サ形動*
ばろーる	バロール	名詞サ変*
ばろん	バロン	名詞サ変*
ばん	バン	名詞サ変$
ばんか	版買	ワ行五段*
ばんかな	バンカナ	名サ形動*
ばんこらん	バンコラン	名詞サ変$
ばんせん	番宣	名詞*
ばんま	番魔	接尾語*
ばんま	番魔	助数詞*
ばんま	番魔	名詞*
ばんま	万魔	名詞*
ぱｓｓ	パｓｓ	名詞*
ぱっかぱか	パッカパカ	名詞サ変*
ぱっきゃいお	パッキャイオ	名詞サ変$
ぱっきゃお	パッキャオ	名サ形動*
ぱっきゃお	パッキャオ	名詞サ変*
ぱっきもん	パッキモン	名詞サ変*
ぱっくん	パックン	名サ形動*
ぱっげー	パッゲー	名詞サ変*
ぱーつ	パーツ	名詞サ変*
ぱーてぃー	パーティー	名詞サ変*
ぱーてぃしょん	パーティション	名詞サ変*
ぱーふぇくと	パーフェクト	名詞サ変*
ぱーふぇくとごる	パーフェクトゴル	名サ形動*
ぱーるう゛ぁてぃ	パールヴァティ	名詞サ変*
ぱいる	パイル	名詞サ変*
ぱう゛ぁろってぃ	パヴァロッティ	名詞サ変*
ぱえりあ	パエリア	名詞サ変*
ぱき	パキ	名サ形動*
ぱく	パク	名サ形動*
ぱく	パク	名詞サ変$
ぱくっても	パクッテモ	名詞サ変*
ぱくられて	パクラレテ	名詞サ変*
ぱくり	パクリ	名詞サ変*
ぱくる	パクル	名詞サ変*
ぱくるの	パクルノ	名サ形動*
ぱけ	パケ	名詞サ変*
ぱこぱこ	パコパコ	名サ形動*
ぱこぱこ	パコパコ	名詞サ変*
ぱこぱこまま	パコパコママ	名詞サ変*
ぱすわーど	パスワード	名詞サ変*
ぱずー	パズー	名詞サ変*
ぱずす	パズス	名詞サ変*
ぱせり	パセリ	名詞サ変*
ぱそこん	パソコン	名詞サ変*
ぱちゃかくま	パチャカクマ	名詞サ変*
ぱちゃかまく	パチャカマク	名詞サ変*
ぱちゅりー	パチュリー	名詞サ変*
ぱちもの	パチモノ	名詞サ変*
ぱとらっしゅ	パトラッシュ	名詞サ変*
ぱとりんぱす	パトリンパス	名詞サ変*
ぱどめ	パドメ	名サ形動*
ぱねる	パネル	名詞サ変*
ぱぱぱぅあー	パパパゥアー	名詞サ変$
ぱぱらっち	パパラッチ	名サ形動*
ぱぴぷぺぼ	パピプペボ	名詞サ変*
ぱぴるさぐ	パピルサグ	名詞サ変*
ぱふぉ	パフォ	名詞サ変*
ぱぷわ	パプワ	名サ形動*
ぱやお	パヤオ	名サ形動*
ぱら	パラ	名詞サ変*
ぱらっぱらっぱー	パラッパラッパー	名詞サ変$
ぱらすあてな	パラスアテナ	名詞サ変*
ぱらそる	パラソル	名詞サ変*
ぱらでぃん	パラディン	名詞サ変*
ぱららでぃ	パララディ	名詞サ変*
ぱられるわーるど	パラレルワールド	名詞サ変*
ぱりぃ	パリィ	名詞サ変$
ぱりぱりごりら	パリパリゴリラ	名詞サ変$
ぱりんぐ	パリング	名詞サ変*
ぱるくーる	パルクール	名サ形動*
ぱるてな	パルテナ	名詞サ変$
ぱるぱてぃーん	パルパティーン	名サ形動*
ぱるみしあ	パルミシア	名詞サ変$
ぱれす	パレス	名詞サ変*
ぱろ	パロ	名サ形動*
ぱわー	パワー	名詞サ変*
ぱわーくらっしゅ	パワークラッシュ	名詞サ変*
ぱんつぇった	パンツェッタ	名詞サ変*
ぱんつまん	パンツマン	名サ形動*
ぱ゜っきゃお	パ゜ッキャオ	名詞サ変*
ひぁーと	ヒァート	名詞サ変*
ひゅ	ヒュ	名サ形動*
ひゅーっ	ヒューッ	名詞サ変*
ひゅーまん	ヒューマン	名詞サ変*
ひゅぷのす	ヒュプノス	名サ形動*
ひょーどる	ヒョードル	名サ形動*
ひょーどる	ヒョードル	名詞サ変*
ひょうかさ	評価去	ラ行五段*
ひょうかされること	評価される事	名詞*
ひょうげんできないこと	表現出来ない事	名詞$
ひょうひ	表非	接頭語*
ひょうひょう	表表	名詞サ変*
ひっ	ヒッ	名詞サ変*
ひっぴー	ヒッピー	名詞サ変*
ひっぷほぷ	ヒップホプ	名サ形動*
ひーひー	ヒーヒー	名サ形動*
ひーひー	ヒーヒー	名詞サ変*
ひーほーくん	ヒーホークン	名詞サ変*
ひーろ	ヒーロ	名サ形動*
ひえい	飛影	名詞*
ひかる	ヒカル	名サ形動*
ひき	ヒキ	名詞サ変$
ひきとり	ヒキトリ	名サ形動*
ひくいそう	低い層	名詞$
ひくそん	ヒクソン	名サ形動*
ひぐらしなみ	ひぐらし並み	名詞*
ひげくま	ヒゲクマ	名詞サ変$
ひさもと	ヒサモト	名詞サ変*
ひしょく	緋色	名詞*
ひそか	ヒソカ	名詞サ変*
ひだり	ヒダリ	名サ形動*
ひつきしんじ	日月神示	名詞*
ひつようなこと	必要な事	名詞*
ひてんみつるぎりゅう	飛天御剣流	名詞*
ひで	ひで	名詞*
ひで	ヒデ	名サ形動*
ひでよし	ヒデヨシ	名詞サ変*
ひときた	人キタ	名詞サ変*
ひとことなた	ﾋﾄｺﾄﾅﾀ	名詞サ変$
ひとつ	ヒトツ	名サ形動*
ひとつのこと	一つの事	名詞*
ひとによ	人に酔	ワ行五段*
ひとのこと	人の事	名詞*
ひとも	人も	名詞*
ひとらー	ヒトラー	名詞サ変*
ひとりもん	ヒトリモン	名サ形動*
ひとんち	人ん地	名詞$
ひどいこと	ひどい事	名詞$
ひなの	雛野	名詞$
ひの	日野	名詞*
ひばごん	ヒバゴン	名詞サ変*
ひひ	緋緋	名詞*
ひひいろ	緋緋色	名詞*
ひひいろかね	緋緋色金	名詞*
ひむらー	ヒムラー	名詞サ変*
ひめねす	ヒメネス	名詞サ変*
ひらいとう	避雷島	名詞*
ひらぎの	ヒラギノ	名詞サ変*
ひらりー	ヒラリー	名詞サ変*
ひり	ヒリ	名サ形動*
ひる	ヒル	名詞サ変$
ひれ	ヒレ	名詞サ変*
ひろ	ヒロ	名サ形動*
ひろ	ヒロ	名詞サ変*
ひろいん	ヒロイン	名詞サ変$
ひろしま	ヒロシマ	名詞サ変*
ひんにゅう	貧乳	名詞$
ひんぬー	ヒンヌー	名詞サ変*
びゃっこ	ビャッコ	名詞サ変*
びゅー	ビュー	名詞サ変*
びゅーね	ビューネ	名詞サ変*
びゅあ	ビュア	名詞サ変$
びっくす	ビックス	名サ形動*
びっくりまん	ビックリマン	名サ形動*
びっぐまむ	ビッグマム	名詞サ変$
びっしり	ビッシリ	名サ形動*
びっち	ビッチ	名サ形動*
びっち	ビッチ	名詞サ変*
びっちびっち	ビッチビッチ	名サ形動*
びっちびち	ビッチビチ	名詞サ変$
びーとるず	ビートルズ	名詞サ変*
びーどるず	ビードルズ	名サ形動*
びえり	ビエリ	名サ形動*
びくん	ビクン	名詞サ変*
びしゃもん	ビシャモン	名詞サ変*
びしゃもんてん	ビシャモンテン	名詞サ変*
びじゅ	ビジュ	名詞サ変*
びたなりっしゅおーじお	ビタナリッシュオージオ	名詞サ変$
びちゅん	ﾋﾞﾁｭﾝ	名詞サ変*
びでおかーど	ビデオカード	名詞サ変*
びとう	微糖	名詞*
びびる	ビビル	名詞サ変*
びふないと	ビフナイト	名サ形動*
びふろんす	ビフロンス	名詞サ変*
びみょうな	微妙菜	名詞$
びりー	ビリー	名詞サ変*
びりーしーん	ビリーシーン	名詞サ変$
びるだー	ビルダー	名詞サ変*
びれそん	微レ存	名詞*
びろーど	ビロード	名詞サ変*
びんびん	ビンビン	名詞サ変*
ぴゅ	ピュ	名サ形動*
ぴょん	ピョン	名詞サ変$
ぴょん	ﾋﾟｮﾝ	名詞サ変$
ぴっち	ピッチ	名詞サ変$
ぴあ	ピア	名詞サ変*
ぴあれい	ピアレイ	名詞サ変*
ぴえろ	ピエロ	名詞サ変*
ぴかそ	ピカソ	名詞サ変*
ぴぎー	ピギー	名サ形動*
ぴくしー	ピクシー	名詞サ変*
ぴこーん	ピコーン	名詞サ変*
ぴざ	ピザ	名詞サ変*
ぴざーら	ピザーラ	名詞サ変*
ぴしゃーちゃ	ピシャーチャ	名詞サ変*
ぴしゅ	ぴしゅ	名詞サ変$
ぴしゅ	ピシュ	名詞サ変$
ぴす	ピス	名詞サ変$
ぴたっ	ピタッ	名詞サ変*
ぴちぴち	ピチピチ	名詞サ変*
ぴとー	ピトー	名詞サ変*
ぴりぴり	ピリピリ	名詞サ変*
ぴるろ	ピルロ	名サ形動*
ぴんきー	ピンキー	名詞サ変*
ぴんきり	ピンキリ	名サ形動*
ぴんすとらいぷ	ピンストライプ	名サ形動*
ぴんぽいんと	ピンポイント	名サ形動*
ふぁ	ファ	名サ形動*
ふぁ	ファ	名詞サ変*
ふぁっ	ﾌｧｯ	名詞サ変$
ふぁっきゅーみっや	ファッキューミッヤ	名詞サ変$
ふぁっく	ファック	名詞サ変*
ふぁっし	ファッシ	名詞サ変*
ふぁー	ファー	名詞サ変$
ふぁーす	ファース	名サ形動*
ふぁーれんはいと	ファーレンハイト	名詞サ変$
ふぁいｒ	フェア	名サ形動$
ふぁいあぶれす	ファイアブレス	名詞サ変*
ふぁいと	ファイト	名詞サ変*
ふぁいなるぬーど	ファイナルヌード	名詞サ変*
ふぁいばー	ファイバー	名詞サ変*
ふぁいふぁい	ファイファイ	名詞サ変*
ふぁいやーまん	ファイヤーマン	名サ形動*
ふぁいらー	ファイラー	名詞サ変*
ふぁいるたいぷ	ファイルタイプ	名詞サ変*
ふぁふにーる	ファフニール	名詞サ変*
ふぁみ	ファミ	名詞サ変*
ふぁみおん	ファミオン	名詞サ変*
ふぁみこん	ファミコン	名詞サ変*
ふぁみすた	ファミスタ	名サ形動*
ふぁみつう	ファミ痛	名詞*
ふぁみりー	ファミリー	名詞サ変*
ふぁるろす	ファルロス	名サ形動*
ふぁん	ファン	名詞サ変*
ふぁんたーじ	ファンタージ	名サ形動*
ふぁんたじー	ファンタジー	名詞サ変*
ふぁんたじすた	ファンタジスタ	名サ形動*
ふぁんとむはいう゛	ファントムハイヴ	名詞サ変$
ふぁんなら	ファンナラ	名詞サ変*
ふぃ	フィ	名詞サ変$
ふぃｋ	フィｋ	名詞サ変$
ふぃーご	フィーゴ	名サ形動*
ふぃーご	フィーゴ	名詞サ変*
ふぃーごと	フィーゴト	名サ形動*
ふぃすと	フィスト	名詞サ変*
ふぃでぃお	フィディオ	名詞サ変$
ふぃらしす	フィラシス	名サ形動*
ふぃるむ	フィルム	名詞サ変*
ふぃろそま	フィロソマ	名詞サ変$
ふぃん	フィン	名詞サ変$
ふぇっとちーね	フェットチーネ	名詞サ変$
ふぇーだー	フェーダー	名サ形動*
ふぇありー	フェアリー	名詞サ変*
ふぇありーちぇいん	フェアリーチェイン	名詞サ変*
ふぇいと	フェイト	名詞サ変$
ふぇす	フェス	名サ形動*
ふぇち	フェチ	名サ形動*
ふぇてーす	フェテース	名詞サ変*
ふぇにっくす	フェニックス	名詞サ変*
ふぇら	フェラ	名詞サ変*
ふぇらーりである	フェラーリデアル	名サ形動*
ふぇらちお	フェラチオ	名サ形動*
ふぇるぷす	フェルプス	名サ形動*
ふぇんりる	フェンリル	名詞サ変*
ふぉっぐぶれす	フォッグブレス	名詞サ変*
ふぉーす	フォース	名詞サ変*
ふぉーど	フォード	名詞サ変*
ふぉーむ	フォーム	名詞サ変*
ふぉーめーしょんさっかー	フォーメーションサッカー	名サ形動*
ふぉーもりあ	フォーモリア	名詞サ変*
ふぉあぼーる	フォアボール	名サ形動*
ふぉう	フォウ	名サ形動*
ふぉしな	フォシナ	名サ形動*
ふぉぼす	フォボス	名詞サ変*
ふぉめ	フォメ	名詞サ変*
ふぉるかす	フォルカス	名サ形動*
ふぉるだ	フォルダ	名詞サ変*
ふぉるとぅな	フォルトゥナ	名詞サ変*
ふぉるなくす	フォルナクス	名詞サ変*
ふぉるねうす	フォルネウス	名詞サ変$
ふぉれすとおうが	フォレストオウガ	名詞サ変*
ふぉれすとでもん	フォレストデモン	名詞サ変*
ふぉろうあー	フォロウアー	名詞サ変$
ふぉん％は	フォン％ハ	名詞サ変*
ふぉんｔ	フォント	名サ形動$
ふぉんと	フォント	名詞サ変*
ふぉんとさい	フォントサイ	名詞サ変*
ふゅーちゃー	フューチャー	名詞サ変*
ふってん	振ってン	名詞サ変*
ふっと	フット	名詞サ変*
ふーか	フーカ	名詞サ変$
ふーん	ﾌｰﾝ	名詞サ変*
ふうき	フウキ	名詞サ変*
ふかく	フカク	名サ形動*
ふかさん	不可算	名詞*
ふかわくん	ﾌｶﾜｸﾝ	名詞サ変$
ふくざつなこと	複雑な事	名詞$
ふくしま	フクシマ	名詞サ変$
ふけ	負毛	名詞*
ふけ	ふけ	名詞サ変$
ふけあ	フケア	名詞サ変$
ふざけむなぁ	フザケムナァ	名詞サ変*
ふじょし	腐女子	名詞*
ふじむすめ	フジムスメ	名サ形動*
ふそう	斧鎗	名詞$
ふた	フタ	名サ形動*
ふたえのきわみ	フタエノキワミ	名サ形動*
ふたつでき	二つ出来	一段動詞*
ふたつのすぴか	フタツノスピカ	名サ形動*
ふたなり	フタナリ	名詞サ変*
ふつ	フツ	名詞サ変$
ふつうにし	普通に詩	名詞*
ふつうのこと	普通の事	名詞$
ふつめん	フツメン	名詞サ変*
ふなぐち	船口	名詞$
ふはいしき	腐敗仕切	ラ行五段$
ふひひ	フヒヒ	名サ形動*
ふひひ	ﾌﾋﾋ	名詞*
ふべ	負部	名詞*
ふまえてみ	踏まえて見	一段動詞*
ふまる	フマル	名詞サ変$
ふまるさん	フマルさん	名詞$
ふら	フラ	名サ形動*
ふらっとぴっころ	フラットピッコロ	名詞サ変$
ふらぐ	フラグ	名詞サ変*
ふらわーねっくれす	フラワーネックレス	名詞サ変*
ふらんしすか	フランシスカ	名詞サ変*
ふらんす	フランス	名詞サ変*
ふらんべるじゅ	フランベルジュ	名詞サ変*
ふり	フリ	名サ形動*
ふりゅーてっど	フリューテッド	名詞サ変*
ふりっ	フリッ	名詞サ変$
ふりー	フリー	名詞サ変*
ふりーそふと	フリーソフト	名詞サ変*
ふりあえ	フリアエ	名詞サ変$
ふりお	フリオ	名詞サ変*
ふりこ	フリコ	名詞サ変*
ふる	フル	名詞サ変*
ふるーと	フルート	名詞サ変*
ふるすくりーん	フルスクリーン	名詞サ変*
ふるめたる	フルメタル	名詞サ変$
ふれ	フレ	名詞サ変*
ふれっつ	フレッツ	名サ形動*
ふれーず	フレーズ	名詞サ変*
ふれーむ	フレーム	名詞サ変*
ふれい	フレイ	名詞サ変*
ふれいみーず	フレイミーズ	名詞サ変*
ふれいむ	フレイム	名詞サ変*
ふれいむぐりーぶ	フレイムグリーブ	名詞サ変*
ふれすべるく	フレスベルク	名詞サ変*
ふれすべるぐ	フレスベルグ	名詞サ変*
ふれてみ	触れて見	一段動詞$
ふれん	フレン	名詞サ変$
ふろ	フロ	名サ形動*
ふろっぴー	フロッピー	名詞サ変*
ふろすと	フロスト	名詞サ変*
ふろむ	フロム	名詞サ変*
ふろんと	フロント	名詞サ変*
ぶっｄｙ	ｂｕｄｄｙ	名詞サ変$
ぶっくまーく	ブックマーク	名詞サ変*
ぶった	ブッタ	名詞サ変*
ぶっだ	ブッダ	名詞サ変*
ぶーじ	ブージ	名詞サ変*
ぶーすた	ブースタ	名詞サ変*
ぶーすとあっぷ	ブーストアップ	名詞サ変*
ぶーつ	ブーツ	名詞サ変*
ぶい	ブイ	名詞サ変$
ぶう	ブウ	名詞サ変$
ぶかれすと	ブカレスト	名詞サ変*
ぶさ	ブサ	名サ形動*
ぶさい	ブサイ	名サ形動*
ぶさいく	ブサイク	名サ形動*
ぶさいく	ブサイク	名詞サ変*
ぶさめん	ブサメン	名詞サ変*
ぶざー	ブザー	名詞サ変*
ぶしゅ	ﾌﾞｼｭ	名詞サ変$
ぶしどー	ブシドー	名詞サ変*
ぶしどーぶれーど	ブシドーブレード	名サ形動*
ぶしどーぶれーど	ブシドーブレード	名詞サ変*
ぶす	ブス	名サ形動*
ぶす	ブス	名詞サ変*
ぶすい	ブスイ	名サ形動*
ぶすきゃらん	ブスキャラン	名サ形動*
ぶたしら	ブタシラ	名詞サ変$
ぶちぎれ	ブチギレ	名詞サ変$
ぶつり	ぶつり	名詞*
ぶつりぎょう	物理行	名詞*
ぶつりすた	ブツリスタ	名詞サ変*
ぶとり	ブトリ	名詞サ変*
ぶふだいん	ブフダイン	名詞サ変*
ぶふへら	ブフヘラ	名詞サ変*
ぶらっく	ブラック	名詞サ変*
ぶらっくか	ブラック化	名詞サ変$
ぶらっくふぁっく	ブラックファック	名詞サ変*
ぶらっくまりあ	ブラックマリア	名詞サ変*
ぶらっくらいだー	ブラックライダー	名詞サ変*
ぶらっくらいだへ	ブラックライダヘ	名詞サ変*
ぶらっど	ブラッド	名詞サ変*
ぶらっどちぇいん	ブラッドチェイン	名詞サ変*
ぶらふまー	ブラフマー	名サ形動*
ぶらふまー	ブラフマー	名詞サ変*
ぶり	ブリ	名詞サ変*
ぶりーずらいと	ブリーズライト	名詞サ変*
ぶりーちーず	ブリーチーズ	名サ形動*
ぶりがんだいん	ブリガンダイン	名詞サ変*
ぶるーすくりーん	ブルースクリーン	名詞サ変*
ぶるーばっく	ブルーバック	名サ形動*
ぶるーりんぐ	ブルーリング	名詞サ変*
ぶるく	ブルク	名サ形動*
ぶるるん	ブルルン	名詞サ変$
ぶれ	ブレ	名詞サ変*
ぶれーど	ブレード	名詞サ変*
ぶれーどらんなー	ブレードランナー	名詞サ変*
ぶれいばんと	ブレイバント	名詞サ変*
ぶれすおぶふぁいあ	ブレスオブファイア	名詞サ変$
ぶれすと	ブレスト	名詞サ変*
ぶれん	ブレン	名詞サ変$
ぶれんだー	ブレンダー	名詞サ変*
ぶろきっず	ブロキッズ	名サ形動*
ぶろきっど	ブロキッド	名サ形動*
ぶろんそん	ブロンソン	名詞サ変$
ぶん	ブン	名サ形動*
ぶんかいでき	分解出来	一段動詞*
ぷーちん	プーチン	名詞サ変*
ぷぴーな	プピーナ	名詞サ変$
ぷらいむ	プライム	名詞サ変*
ぷらぐいん	プラグイン	名サ形動*
ぷらぐいん	プラグイン	名詞サ変*
ぷらす	プラス	名詞サ変*
ぷらちな	プラチナ	名詞サ変$
ぷらねっとらいか	プラネットライカ	名詞サ変*
ぷらぴ	プラピ	名詞サ変*
ぷらぴあきれす	プラピアキレス	名詞サ変*
ぷりけつ	プリケツ	名詞サ変*
ぷりてぃさみー	プリティサミー	名サ形動*
ぷりびゅーあ	プリビューア	名詞サ変*
ぷりぷり	プリプリ	名詞サ変*
ぷりんしぱりてぃ	プリンシパリティ	名詞サ変*
ぷりんす	プリンス	名詞サ変*
ぷりんせす	プリンセス	名詞サ変*
ぷりんた	プリンタ	名詞サ変*
ぷるしぇんこ	プルシェンコ	名詞サ変*
ぷれーしゅう	プレー集	名詞$
ぷれいすてーしょん	プレイステーション	名サ形動*
ぷれいでき	プレイ出来	一段動詞*
ぷれいやー	プレイヤー	名詞サ変*
ぷれみあ	プレミア	名詞サ変*
ぷれんだー	プレンダー	名詞サ変*
ぷろ	プロ	名詞サ変*
ぷろぴあにすと	プロピアニスト	名詞サ変*
ぷろふぁいる	ぷろふぁいる	名詞サ変*
ぷろめてうす	プロメテウス	名詞サ変*
ぷろんぷと	プロンプト	名詞サ変*
ぷんぷん	プンプン	名詞サ変*
へｍ	ヘｍ	名詞サ変$
へっど	ヘッド	名詞サ変*
へいが	ヘイガ	名詞サ変*
へいは	ヘイハ	名詞サ変*
へいへ	ヘイヘ	名詞サ変$
へいむだ	ヘイムダ	名詞サ変*
へいむだる	ヘイムダル	名詞サ変*
へいるすとーむ	ヘイルストーム	名詞サ変*
へかーて	ヘカーテ	名詞サ変*
へかとん	ヘカトン	名詞サ変*
へかとんけいる	ヘカトンケイル	名詞サ変*
へけと	ヘケト	名詞サ変*
へこへこ	ヘコヘコ	名サ形動*
へす	ヘス	名詞サ変*
へすす	ヘスス	名詞サ変$
へたーり	ヘターリ	名サ形動*
へたりあ	ヘタリア	名サ形動*
へたれ	ヘタレ	名サ形動*
へびー	ヘビー	名詞サ変*
へびーきゅう	ヘビー球	名詞*
へぶん	ヘブン	名詞サ変*
へぶんくらっぱー	ヘブンクラッパー	名詞サ変*
へぼ	ヘボ	名サ形動*
へむ	ヘム	名詞サ変$
へらじか	ヘラジカ	名詞サ変$
へらすこと	減らす事	名詞$
へりんとん	ヘリントン	名詞サ変*
へる	ヘル	名詞サ変*
へるずくらい	ヘルズクライ	名詞サ変*
へるむ	ヘルム	名詞サ変*
へろへろ	ヘロヘロ	名サ形動*
べっかむ	ベッカム	名サ形動*
べっきん	ベッキン	名詞サ変$
べっけんばうあー	ベッケンバウアー	名詞サ変*
べっどるーむ	ベッドルーム	名サ形動*
べーこん	ベーコン	名詞サ変*
べーしっく	ベーシック	名詞サ変*
べーとー	ベートー	名サ形動*
べーとーう゛ぇん	ベートーヴェン	名詞サ変*
べーとーべんは	ベートーベンハ	名サ形動*
べあーど	ベアード	名サ形動*
べいぐなーど	ベイグナード	名詞サ変*
べいぐらんと	ベイグラント	名詞サ変*
べいだー	ベイダー	名サ形動*
べくと	ベクト	名サ形動*
べじぇ	ベジェ	名詞サ変*
べじーた	ベジータ	名サ形動*
べす	ベス	名サ形動*
べすたん	ベスタン	名サ形動*
べすと	ベスト	名詞サ変*
べすとばうと	ベストバウト	名詞サ変*
べたべた	ベタベタ	名サ形動*
べつに	ベツニ	名サ形動*
べつに	べつに	名詞サ変*
べつにでき	べつに出来	一段動詞$
べてぃ	ベティ	名詞サ変*
べとべとじゃ	ベトベトジャ	名サ形動*
べねでぃく	ベネディク	名サ形動*
べのむすぱいだー	ベノムスパイダー	名詞サ変*
べのんざっぱー	ベノンザッパー	名詞サ変*
べびーぶーむ	ベビーブーム	名サ形動*
べびーりーふ	ベビーリーフ	名詞サ変*
べほま	ベホマ	名詞サ変$
べよ	ベヨ	名詞サ変*
べりす	ベリス	名詞サ変$
べりと	ベリト	名詞サ変*
べりんがー	ベリンガー	名詞サ変$
べる	ベル	名詞サ変*
べる・	ベル・	名詞サ変*
べるせるく	ベルセルク	名詞サ変*
べるぜぶ	ベルゼブ	名詞サ変$
べるぜぶぶ	ベルゼブブ	名詞サ変$
べると	ベルト	名詞サ変*
べるとーちか	ベルトーチカ	名サ形動*
べん	ベン	名詞サ変*
べんじょんそん	ベンジョンソン	名サ形動*
べんぜま	ベンゼマ	名詞サ変$
べんはー	ベンハー	名サ形動*
べんべんべん	ベンベンベン	名詞サ変$
ぺっとぼとる	ペットボトル	名サ形動*
ぺいる	ペイル	名詞サ変*
ぺいるらいだー	ペイルライダー	名詞サ変*
ぺいんとれーど	ペイントレード	名詞サ変*
ぺざんと	ペザント	名サ形動*
ぺしっ	ペシッ	名サ形動*
ぺちぺち	ペチペチ	名詞サ変*
ぺとらでぃ	ペトラディ	名サ形動*
ぺど	ペド	名サ形動*
ぺどろ	ペドロ	名詞サ変*
ぺねろぷ	ペネロプ	名詞サ変*
ぺぷし	ペプシ	名詞サ変*
ぺぷしそ	ペプシソ	名詞サ変*
ぺぺろんちー	ペペロンチー	名サ形動*
ぺぺろんちーの	ペペロンチーノ	名サ形動*
ぺらぺらそーす	ペラペラソース	名サ形動*
ぺり	ペリ	名詞サ変*
ぺりー	ペリー	名詞サ変*
ぺる	ペル	名サ形動*
ぺるせぽねー	ペルセポネー	名詞サ変*
ぺるそな	ペルソナ	名詞サ変*
ぺるそん	ペルソン	名サ形動*
ぺれ	ペレ	名詞サ変*
ぺろ	ﾍﾟﾛ	名詞サ変$
ぺろ	ペロ	名詞サ変$
ぺろぺろ	ペロペロ	名詞サ変$
ぺん	ペン	名詞サ変*
ぺんだんと	ペンダント	名詞サ変*
ぺんね	ペンネ	名詞サ変$
ほって	ホッテ	名サ形動*
ほっとどっく	ホットドック	名詞サ変*
ほっともっと	ホットモット	名サ形動*
ほーきー	ホーキー	名サ形動*
ほーむれす	ホームレス	名詞サ変*
ほーも	ホーモ	名サ形動*
ほーもねーた	ホーモネータ	名詞サ変*
ほーもり	ホーモリ	名サ形動*
ほーんどあうる	ホーンドアウル	名サ形動*
ほあ	ホア	名サ形動*
ほあきん	ホアキン	名詞サ変*
ほい	ホイ	名サ形動*
ほいこーろー	ホイコーロー	名詞サ変*
ほいみ	ホイミ	名詞サ変$
ほうぅ	ホウゥ	名サ形動*
ほうおう	ホウオウ	名詞サ変$
ほうがし	方が士	名詞*
ほうがよ	方が夜	名詞$
ほうがよ	方が世	名詞$
ほうじ	方治	固有人名$
ほうせい	邦正	接頭語*
ほうぞういん	宝蔵院	名詞*
ほかのきゃら	ホカノキャラ	名サ形動*
ほくぎん	北銀	名詞*
ほくと	ホクト	名詞サ変$
ほしいところ	欲しい所	名詞*
ほしくないこと	ほしくない事	名詞$
ほしや	★や	ラ行五段*
ほなーせっく	ホナーセック	名詞サ変$
ほばー	ホバー	名詞サ変$
ほびろん	ホビロン	名詞サ変$
ほぷきんす	ホプキンス	名サ形動*
ほほ	ホホ	名詞サ変*
ほむす	ホムス	名詞サ変$
ほむず	ホムズ	名詞サ変$
ほめ	ホメ	名詞サ変*
ほも	ホモ	名詞サ変*
ほもっくす	ホモックス	名サ形動*
ほもーぽったー	ホモーポッター	名詞サ変$
ほもかんぺんですね	ホモカンペンデスネ	名詞サ変*
ほもがき	ホモガキ	名詞サ変$
ほもじゃ	ホモジャ	名詞サ変*
ほもせっくす	ホモセックス	名詞サ変*
ほもだち	ホモダチ	名詞サ変$
ほもは	ほもは	名詞サ変$
ほもび	ホモビ	名詞サ変*
ほもふぁーれ	ホモファーレ	名詞サ変$
ほや	ホヤ	名詞サ変$
ほやほや	ホヤホヤ	名サ形動*
ほら	ホラ	名サ形動*
ほら	ホラ	名詞サ変$
ほらー	ホラー	名詞サ変*
ほり	ホリ	名サ形動*
ほりえもん	ホリエモン	名詞サ変*
ほろろ	ホロロ	名詞サ変*
ほろろじうむ	ホロロジウム	名詞サ変*
ほわいとべーす	ホワイトベース	名サ形動*
ほわいとらいだー	ホワイトライダー	名詞サ変*
ほんあんだ	本安打	助数詞$
ほんあんだ	本安打	名詞サ変$
ほんだ	ホンダ	名詞サ変*
ほんと	ホント	名詞サ変*
ほんとしろ	ホント城	名詞$
ほんとのこと	ホントのコト	名詞サ変*
ほんまん	ホンマン	名サ形動*
ぼっかい	ぼっかい	名詞サ変*
ぼっくす	ボックス	名詞サ変*
ぼっこ	ボッコ	名詞サ変*
ぼったくり	ボッタクリ	名詞サ変*
ぼっふぁｍｂぇ	boffamble	名詞サ変$
ぼーがー	ボーガー	名サ形動*
ぼーぐ	ボーグ	名詞サ変*
ぼーぐばとる	ボーグバトル	名サ形動*
ぼーじょ	ボージョ	名サ形動*
ぼーでぃーず	ボーディーズ	名詞サ変*
ぼーど	ボード	名詞サ変*
ぼーる	ボール	名詞サ変*
ぼーるど	ボールド	名詞サ変*
ぼいす	ボイス	名詞サ変*
ぼう	ボウ	名詞サ変*
ぼうい	ボウイ	名サ形動*
ぼうい	ボウイ	名詞サ変$
ぼうりょくてき	暴力敵	名詞*
ぼうる	ボウル	名詞サ変*
ぼきゃ	ボキャ	名詞サ変$
ぼく	ボク	名サ形動*
ぼくおーん	ボクオーン	名詞サ変*
ぼくさーずろーど	ボクサーズロード	名サ形動*
ぼけ	ボケ	名詞サ変$
ぼけきゃら	ボケキャラ	名サ形動*
ぼこ	ボコ	名詞サ変*
ぼこられる	ボコラレル	名詞サ変*
ぼこれ	ボコレ	名詞サ変*
ぼな	ボナ	名サ形動*
ぼなんざ	ボナンザ	名サ形動*
ぼね	ボネ	名詞サ変$
ぼの	ボノ	名詞サ変*
ぼぶ	ボブ	名詞サ変*
ぼまーらんさー	ボマーランサー	名詞サ変$
ぼむでぃ	ボムディ	名詞サ変*
ぼり	ボリ	名詞サ変*
ぼるが	ボルガ	名詞サ変*
ぼるたれん	ボルタレン	名詞サ変*
ぼるまん	ボルマン	名詞サ変*
ぼろねーぜ	ボロネーゼ	名詞サ変$
ぼろまけ	ボロ負け	名詞サ変*
ぼん	ボン	名詞サ変*
ぼんてーじ	ボンテージ	名サ形動*
ぼんてーじますたー	ボンテージマスター	名サ形動*
ぼんでーじ	ボンデージ	名サ形動*
ぼんでーじ	ボンデージ	名詞サ変*
ぽっち	ポッチ	名サ形動*
ぽいずま	ポイズマ	名詞サ変*
ぽいてーろ	ポイテーロ	名詞サ変$
ぽいんた	ポインタ	名詞サ変*
ぽう	ﾎﾟｳ	名詞*
ぽえまー	ポエマー	名詞サ変$
ぽかーん	ﾎﾟｶｰﾝ	名詞サ変*
ぽき	ポキ	名詞サ変$
ぽきもん	ポキモン	名詞サ変*
ぽじぽじ	ポジポジ	名詞サ変$
ぽずむてぃ	ポズムティ	名詞サ変*
ぽずむでぃ	ポズムディ	名詞サ変*
ぽぜっしょん	ポゼッション	名詞サ変$
ぽてち	ポテチ	名サ形動*
ぽなんざ	ポナンザ	名詞サ変$
ぽにょ	ポニョ	名サ形動*
ぽぱすま	ポパスマ	名詞サ変*
ぽぴゅらー	ポピュラー	名詞サ変*
ぽぶりあん	ポブリアン	名詞サ変*
ぽりす	ポリス	名詞サ変*
ぽりすのーつ	ポリスノーツ	名サ形動*
ぽりんきー	ポリンキー	名詞サ変*
ぽるたーがいすと	ポルターガイスト	名詞サ変*
ぽるの	ポルノ	名詞サ変*
ぽろぽろ	ポロポロ	名詞サ変*
ぽわそ	ポワソ	名詞サ変*
ぽん	ポン	名詞サ変*
まっ	マッ	名サ形動*
まっくいきなさい	マックイキナサイ	名サ形動*
まっくす	マックス	名詞サ変*
まっくん	マックン	名サ形動*
まっけんじー	マッケンジー	名詞サ変*
まっこいず	マッコイズ	名詞サ変$
まっどまっくす	マッドマックス	名詞サ変$
まっはどらいぶ	マッハドライブ	名詞サ変*
まっぷ	マップ	名詞サ変*
まー	マー	名詞サ変*
まーきゅりーぽいずん	マーキュリーポイズン	名詞サ変*
まーしー	マーシー	名詞サ変*
まーぶるひーろーず	マーブルヒーローズ	名詞サ変*
まーやー	マーヤー	名詞サ変*
まーら	マーラ	名サ形動*
まーら	マーラ	名詞サ変*
まーりぃ	マーリィ	名サ形動*
まーろん・ぶらんど	マーロン・ブランド	名詞サ変*
まーん	マーン	名詞サ変*
まあなる	マアナル	名サ形動*
まい	マイ	名詞サ変*
まいあ	マイア	名サ形動*
まいきー	マイキー	名詞サ変*
まいきへ	マイキヘ	名詞サ変*
まいけつ	マイケツ	名サ形動*
まいける	マイケル	名詞サ変*
まいしん	マイシン	名詞サ変$
まいや	マイヤ	名詞サ変$
まいりす	マイリス	名サ形動*
まいりすと	マイリスト	名詞サ変*
まいんど	マインド	名詞サ変*
まいんどしーかー	マインドシーカー	名詞サ変*
まう	マウ	名詞サ変*
まうきん	マウ金	名詞*
まうすすくろーる	マウススクロール	名詞サ変*
まうすぱっど	マウスパッド	名サ形動*
まうすほいー	マウスホイー	名詞サ変*
まえけん	マエケン	名詞サ変$
まえふり	前フリ	名サ形動*
まえら	まえら	接尾語*
まかー	マカー	名詞サ変*
まかーい	マカーイ	名詞サ変*
まかーに	マカーニ	名詞サ変*
まかーぷる	マカープル	名詞サ変*
まかじゃま	マカジャマ	名詞サ変*
まかみ	マカミ	名詞サ変*
まから	マカラ	名詞サ変*
まからかーん	マカラカーン	名詞サ変*
まき	マキ	名詞サ変*
まきゃべり	マキャベリ	名詞サ変*
まきょう	魔郷	接尾語*
まきー	マキー	名詞サ変*
まきし	マキシ	名詞サ変*
まぎ	マギ	名詞サ変$
まく	マク	名詞サ変*
まくがわん	マクガワン	名詞サ変$
まくろ	マクロ	名詞サ変*
まくろびおてぃっく	マクロビオティック	名詞サ変*
まぐす	マグス	名詞サ変$
まぐわいあ	マグワイア	名サ形動*
まけいん	マケイン	名サ形動*
まけてるところ	負けてる所	名詞*
まけること	負ける事	名詞$
まご	マゴ	名詞サ変$
まさき	マサキ	名詞サ変$
まさる	マサル	名詞サ変*
まざー	マザー	名詞サ変*
まし	マシ	名詞サ変*
まじ	本気	名詞*
まじ	マジ	名詞サ変$
まじゅう	魔獣	名詞*
まじょか	魔女化	名詞サ変$
まじっく	マジック	名詞サ変*
まじかる	マジカル	名サ形動*
まじかるどろっぷ	マジカルドロップ	名サ形動*
まじきち	マジキチ	名詞サ変*
まじしあい	マジ試合	名詞サ変*
まじな	本気な	名詞*
まじん	まじん	名詞サ変*
まじん	魔人	接尾語*
ます	マス	名詞サ変*
ますお	マスオ	名サ形動*
ますごみ	マスゴミ	名詞*
ますたーすれーぶ	マスタースレーブ	名詞サ変*
ますたり	マスタリ	名詞サ変*
ますたりー	マスタリー	名詞サ変*
ますみ	マスミ	名詞サ変$
ませまてぃか	マセマティカ	名詞サ変$
ませらってぃ	マセラッティ	名詞サ変$
まぞ	マゾ	名詞サ変*
また	マタ	名詞サ変*
またどーる	マタドール	名詞サ変*
まちがいる	マチガイル	名サ形動*
まつちゃん	松ちゃん	名詞$
まつに	松似	一段動詞$
まとりっくす	マトリックス	名詞サ変*
まどんば	マドンバ	名サ形動*
まな	マナ	名詞サ変$
まな	真菜	固有人名$
まなぶこと	学ぶ事	名詞*
まに	マニ	名詞サ変$
まにー	マニー	名詞サ変*
まにあくす	マニアクス	名詞サ変*
まにふれっくす	マニフレックス	名詞サ変$
まぬ	マヌ	名詞サ変*
まね	マネ	名詞サ変$
まねじゃー	マネジャー	名詞サ変*
まは	マハ	名詞サ変*
まはがるだいん	マハガルダイン	名詞サ変*
まはじおだいん	マハジオダイン	名詞サ変*
まはじおんが	マハジオンガ	名詞サ変*
まはぶふーら	マハブフーラ	名詞サ変*
まはぶふだいん	マハブフダイン	名詞サ変*
まはむど	マハムド	名詞サ変*
まはむどおん	マハムドオン	名詞サ変*
まはらぎ	マハラギ	名詞サ変*
まはらぎおん	マハラギオン	名詞サ変*
まはらぎだいん	マハラギダイン	名詞サ変*
まはんまおん	マハンマオン	名詞サ変*
まひろ	マヒロ	名詞サ変$
まひろうむ	マヒロウム	名詞サ変$
まふぃあ	マフィア	名詞サ変*
まぶけあ	マブケア	名サ形動*
まま	ママ	名詞サ変*
ままくさ	ママクサ	名詞サ変*
ままさー	ママサー	名詞サ変*
まませー	ママセー	名詞サ変*
ままちゃり	ママチャリ	名サ形動*
ままん	ママン	名詞サ変$
まみ	魔未	接頭語*
まみ	マミ	名詞サ変$
まみむめも	マミムメモ	名詞サ変*
まめだぬき	マメダヌキ	名詞サ変*
まも	マモ	名詞サ変$
まもること	守る事	名詞$
まやうぇる	マヤウェル	名詞サ変*
まら	マラ	名詞サ変*
まらおけ	マラオケ	名詞サ変*
まらどーな	マラドーナ	名詞サ変*
まらどら	まらどら	名詞*
まり	マリ	名詞サ変*
まりあの	マリアノ	名詞サ変*
まりあり	マリアリ	名サ形動*
まりお	マリオ	名詞サ変*
まりさ	マリサ	名サ形動*
まる	マル	名詞サ変*
まるーん	マルーン	名詞サ変*
まるかわ	マルカワ	名詞サ変$
まるがり	マルガリ	名詞サ変*
まるがりーと	マルガリート	名サ形動*
まるがりーと	マルガリート	名詞サ変*
まるけす	マルケス	名詞サ変*
まるげん	丸源	名詞*
まるげん	丸元	名詞*
まるこ	マルコ	名詞サ変$
まるご	マルゴ	名詞サ変$
まるご	丸ゴ	名詞サ変$
まるさん	○さん	名詞$
まるち	マルチ	名詞サ変*
まるちこあ	マルチコア	名詞サ変*
まるでぃーに	マルディーニ	名詞サ変*
まるべり	マルベリ	名詞サ変$
まるまる	○○	名詞$
まわってないとき	回ってない時	名詞$
まん	マン	名詞サ変*
まんが	マンガ	名詞サ変*
まんがん	マンガン	名詞サ変$
まんぐらい	万ぐらい	助数詞$
まんこ	マンコ	名詞サ変*
まんさ	マンサ	名サ形動*
まんせ	マンセ	名サ形動*
まんそん	マンソン	名サ形動*
まんてぃこあ	マンティコア	名詞サ変*
まんと	マント	名詞サ変*
まんどれいく	マンドレイク	名詞サ変*
まんぱわー	万パワー	名詞*
まんまん	マンマン	名詞サ変*
みｇ	ミグ	名サ形動$
みｊかさ	ミｊカサ	名詞サ変$
みゅ	ミュ	名サ形動*
みゅーじ	ミュージ	名サ形動*
みゅーじむ	ミュージム	名サ形動*
みっと	みっと	名詞サ変*
みっや	ミッヤ	名詞サ変$
みーとそーす	ミートソース	名詞サ変*
みえないこと	見えない事	名詞$
みおん	ミオン	名詞サ変*
みおん	みおん	名詞サ変*
みか	ミカ	名詞サ変$
みかえる	ミカエル	名詞サ変*
みかさ	ミカサ	名詞サ変$
みき	ミキ	名詞サ変$
みきし	ミキシ	名詞サ変$
みきしまっくす	ミキシマックス	名詞サ変$
みぎ	→	名詞*
みぎかなと	→カナト	名詞サ変*
みぎむね	→胸	名詞$
みく	ミク	名サ形動*
みくだよー	ﾐｸﾀﾞﾖｰ	名詞サ変$
みこ	ミコ	名サ形動*
みさわ	ミサワ	名詞サ変$
みしゃぐじ	ミシャグジ	名詞サ変*
みじかすぎ	ミジカスギ	名詞サ変$
みすたー	ミスター	名詞サ変*
みすと	ミスト	名詞サ変*
みすど	ミスド	名詞サ変$
みすみそう	ミスミソウ	名詞サ変$
みすら	ミスラ	名詞サ変*
みせがわ	店側	名詞*
みせすでいじー	ミセスデイジー	名詞サ変*
みせるとき	魅せる時	名詞*
みせるのです	ﾐｾﾙﾉﾃﾞｽ	名詞サ変*
みそ	ミソ	名詞サ変*
みたま	ミタマ	名サ形動*
みつるぎ	御剣	名詞*
みづき	三月	固有人姓$
みとめるわけ	認める訳	名詞*
みとらす	ミトラス	名詞サ変*
みとる	ミトル	名詞サ変*
みどな	ミドナ	名詞サ変*
みどり	ミドリ	名詞サ変*
みなとがわ	港川	名詞$
みなもと	ミナモト	名詞サ変$
みに	ミニ	名詞サ変$
みにたこ	ミニタコ	名サ形動*
みねうちか	みねうちか	名詞サ変$
みねね	みねね	名詞サ変$
みのたしろす	ミノタシロス	名詞サ変*
みはいろびっち	ミハイロビッチ	名詞サ変$
みふぁれみどれし	ミファレミドレシ	名詞サ変$
みふぃふぇる	ミフィフェル	名詞サ変*
みほこ	ミホコ	名サ形動*
みほこ	ミホコ	名詞サ変*
みま	未魔	名詞*
みやぎ	ミヤギ	名詞サ変*
みやほん	ミヤホン	名詞サ変*
みらー	ミラー	名詞サ変*
みりょうづき	魅了突き	名詞*
みりしら	ミリシラ	名詞サ変*
みりてぃあ	ミリティア	名サ形動*
みるき	ミルキ	名詞サ変$
みるく	みるく	名詞サ変*
みるこ	ミルコ	名サ形動*
みるころめお	ミルコロメオ	名詞サ変*
みるとん	ミルトン	名詞サ変*
みるよ	見る世	名詞*
みれにあむ	ミレニアム	名詞サ変*
みれるわけ	見れる訳	名詞*
みろくぼさつはんかしゆいぞう	弥勒菩薩半跏思惟像	名詞*
みん	ミン	名サ形動*
みんきーもお	ミンキーモオ	名詞サ変*
みんさが	ミンサガ	名サ形動*
みんすう	民数	接尾語*
みんち	みんち	名詞サ変$
みんな	見んな	名詞*
むっしゅ	ムッシュ	名詞サ変*
むっつりーに	ﾑｯﾂﾘｰﾆ	名詞サ変$
むーう゛ぁー	ムーヴァー	名詞サ変*
むーう゛ぃーず	ムーヴィーズ	名詞サ変$
むーび	ムービ	名サ形動*
むーびーず	ムービーズ	名詞サ変$
むーん・	ムーン・	名詞サ変*
むーんくれすた	ムーンクレスタ	名サ形動*
むいしきか	むいしきか	名詞サ変*
むえたい	ムエタイ	名サ形動*
むかいてん	無回転	名詞サ変*
むかつく	ムカツク	名サ形動*
むき	ムキ	名サ形動*
むき	ムキ	名詞サ変*
むきむき	ムキムキ	名サ形動*
むきや	剥き屋	接尾語*
むさ	ムサ	名サ形動*
むさ	むさ	名詞サ変*
むさし	ムサシ	名詞サ変*
むし	蟲	単漢字$
むしゃ	ムシャ	名詞サ変$
むしゃいど	ムシャイド	名詞サ変$
むしゅふしゅ	ムシュフシュ	名詞サ変*
むしひめ	虫姫	名詞*
むしへん	蟲編	名詞$
むじゅら	ムジュラ	名詞サ変*
むすか	ムスカ	名詞サ変*
むすたふぁぁー	ムスタファァー	名サ形動*
むず	ムズ	名サ形動*
むずい	ムズイ	名サ形動*
むずかしいこと	難しい事	名詞$
むずかしいわけ	難しい訳	名詞*
むずく	ムズク	名サ形動*
むち	ムチ	名サ形動*
むちむち	ムチムチ	名サ形動*
むつごろう	ムツゴロウ	名詞サ変$
むど	ムド	名詞サ変*
むどおん	ムドオン	名詞サ変*
むねあつ	ムネアツ	名詞サ変$
むねにっ	ﾑﾈﾆｯ	名詞サ変$
むみ	むみ	名詞サ変*
むみら	むみら	名詞*
むらかわ	ムラカワ	名サ形動*
むらくも	ムラクモ	名詞サ変$
むらさめ	ムラサメ	名サ形動*
むらむら	ムラムラ	名詞サ変*
むりしてみ	無理して見	一段動詞*
むりはしない	無理は市内	名詞$
むろ	ムロ	名サ形動*
むんく	ムンク	名詞サ変$
むんでぃあうｒ	ムンディアウｒ	名詞*
めゅ	メュ	名詞サ変*
めっー	メッー	名詞サ変*
めっし	メッシ	名サ形動*
めっし	メッシ	名詞サ変*
めっしゅうぃんぐ	メッシュウィング	名詞サ変$
めっしより	メッシヨリ	名サ形動*
めーたー	メーター	名詞サ変*
めい	メイ	名詞サ変*
めいうぇざー	メイウェザー	名詞サ変$
めいかいは	冥界破	名詞*
めいかん	命館	名詞*
めいくらい	メイクライ	名サ形動*
めいじ	メイジ	名サ形動*
めいす	メイス	名サ形動*
めいりお	メイリオ	名詞サ変*
めいん	メイン	名詞サ変*
めがちち	メガチチ	名詞サ変*
めがてん	メガテン	名サ形動*
めがとんぷれす	メガトンプレス	名詞サ変*
めがね	メガネ	名詞サ変*
めがね	目金	名詞*
めがねなし	メガネなし	名詞$
めぎど	メギド	名サ形動*
めぎど	メギド	名詞サ変*
めぎどら	メギドラ	名詞サ変*
めぎどらおん	メギドラオン	名詞サ変*
めこれ	メコレ	名詞サ変*
めさむ	召さむ	名詞*
めしあ	ﾒｼｱ	名詞*
めしあらいざー	メシアライザー	名詞サ変*
めじゃ	メジャ	名詞サ変*
めじゃー	メジャー	名詞サ変*
めた	メタ	名詞サ変*
めたせこいあ	メタセコイア	名詞サ変*
めたとろん	メタトロン	名詞サ変*
めたぼ	メタボ	名サ形動*
めたぼ	メタボ	名詞サ変*
めたもる	メタモル	名サ形動*
めたる	メタル	名詞サ変*
めたるぎあ	メタルギア	名サ形動*
めたんふぁたみん	メタンファタミン	名サ形動*
めだふぉーす	メダフォース	名詞サ変$
めだりお	メダリオ	名サ形動*
めだろったー	メダロッター	名詞サ変$
めだろっと	メダロット	名詞サ変$
めでぃっく	メディック	名詞サ変*
めでぃあ	メディア	名詞サ変*
めでぃあらはん	メディアラハン	名詞サ変*
めでぃか	メディカ	名詞サ変*
めでぃらま	メディラマ	名サ形動*
めでぃらま	メディラマ	名詞サ変*
めでゅーさ	メデューサ	名詞サ変*
めでたい	メデタイ	名詞サ変*
めとろいど	メトロイド	名詞サ変*
めとろぽりたん	メトロポリタン	名詞サ変*
めねらうす	メネラウス	名詞サ変*
めぱとら	メパトラ	名詞サ変*
めもめも	メモメモ	名詞サ変*
めもり	メモリ	名詞サ変*
めりか	メリカ	名詞サ変*
めるこむ	メルコム	名詞サ変*
めろんー	メロンー	名サ形動*
めん	メン	名詞サ変*
めんげれ	メンゲレ	名詞サ変*
めんと	メント	名詞サ変*
めんどい	メンドイ	名詞サ変*
めんなく	メンナク	名サ形動*
めんなく	メンナク	名詞サ変*
めんばー	メンバー	名詞サ変*
もっこす	モッコス	名詞サ変*
もって	物袋	固有人姓$
もっとのびるのです	ﾓｯﾄﾉﾋﾞﾙﾉﾃﾞｽ	名詞サ変*
もー	モー	名詞サ変*
もーしょｎ	モーショｎ	名詞サ変*
もーしょぼー	モーショボー	名詞サ変*
もーしょん	モーション	名詞サ変*
もーす	モース	名詞サ変$
もーたるじはーど	モータルジハード	名詞サ変*
もーつぁる	モーツァル	名サ形動*
もーつぁると	モーツァルト	名詞サ変*
もーど	モード	名詞サ変*
もーるもーす	モールモース	名詞サ変*
もう	申	単漢字$
もうかるよう	儲かる様	名詞形動$
もうまんたい	モウマンタイ	名詞サ変*
もうりょう	モウリョウ	名詞サ変*
もうりーにょ	モウリーニョ	名サ形動*
もかしん	モカシン	名詞サ変*
もくじん	木人	名詞$
もこい	モコイ	名詞サ変$
もじゅーる	モジュール	名詞サ変*
もじゅれーしょん	モジュレーション	名詞サ変$
もじこーど	モジコード	名詞サ変*
もじこーど	文字コード	名詞*
もす	モス	名詞サ変$
もすたーりん	モスターリン	名サ形動*
もすばーがー	モスバーガー	名詞サ変*
もすまん	モスマン	名詞サ変*
もたせようとい	持たせようと言	ワ行五段*
もちべ	モチベ	名詞サ変*
もつ	モツ	名サ形動*
もて	モテ	名詞サ変*
もてすぎ	モテスギ	名詞サ変$
もてて	モテテ	名詞サ変*
もてない	モテナイ	名サ形動*
もてもて	モテモテ	名詞サ変*
もてる	モテル	名サ形動*
もてる	モテル	名詞サ変*
もてることも	モテルコトモ	名詞サ変$
もでらー	モデラー	名詞サ変*
もでる	モデル	名詞サ変*
もと	モト	名詞サ変*
もとねた	モトネタ	名サ形動*
もとめること	求める事	名詞$
もとや	モトヤ	名詞サ変$
もどき	モドキ	名サ形動*
もな	モナ	名サ形動*
もな	もな	名詞サ変*
もな	モナ	名詞サ変$
もにか	モニカ	名詞サ変$
もの	モノ	名詞サ変*
ものほん	モノホン	名詞サ変$
もばいる	モバイル	名詞サ変*
もぶ	モブ	名詞サ変*
もぶきゃら	モブキャラ	名詞サ変*
もほ	モホ	名詞サ変$
もむのふ	モムノフ	名詞サ変*
もめも	もめモ	名詞サ変*
もも	モモ	名詞サ変*
もらくす	モラクス	名詞サ変*
もられす	モラレス	名サ形動*
もられす	モラレス	名詞サ変*
もりっしー	モリッシー	名詞サ変$
もりかわ	モリカワ	名詞サ変$
もりさがり	盛り下がり	接尾語$
もりさがり	盛り下がり	助数詞$
もりさがり	盛り下がり	名詞サ変$
もりさげ	盛り下げ	接尾語$
もりさげ	盛り下げ	助数詞$
もりさげ	盛り下げ	名詞サ変$
もりさわ	モリサワ	名詞サ変$
もりそん	モリソン	名詞サ変*
もるがろん	モルガロン	名詞サ変*
もるげんすてるん	モルゲンステルン	名詞サ変*
もるじ	モルジ	名詞サ変$
もるだう	モルダウ	名詞サ変*
もろ	モロ	名サ形動*
もろく	モロク	名詞サ変*
もん	モン	名サ形動*
もん	モン	名詞サ変*
もんかい	門会	名詞*
もんく	モンク	名詞サ変$
もんく	モン食	ワ行五段$
もんごる	モンゴル	名詞サ変*
もんすーの	モンスーノ	名詞サ変$
もんすたー	モンスター	名詞サ変*
もんだろ	モンダロ	名詞サ変$
もんぶ	もんぶ	名詞*
もんぶ	紋舞	固有人姓$
もんぶらん	モンブラン	名詞サ変$
やっくる	ヤックル	名サ形動*
やったのか	ヤッタノカ	名サ形動*
やって	ヤッテ	名サ形動*
やってよー	ﾔｯﾃﾖｰ	名詞サ変$
やってること	やってる事	名詞*
やー	ヤー	名サ形動*
やー	ヤー	名詞サ変*
やーうぇーい	ヤーウェーイ	名サ形動*
やーう゛ぇい	ヤーヴェイ	名サ形動*
やお	ヤオ	名詞サ変*
やが	矢ガ	名詞*
やきそば	やきそば	名詞サ変$
やく	ヤク	名詞サ変$
やくざ	ヤクザ	名サ形動*
やくざ	ヤクザ	名詞サ変$
やくしにー	ヤクシニー	名詞サ変$
やくちゅう	薬中	接尾語$
やくちゅう	薬中	名詞$
やくどかえる	ヤクドカエル	名詞サ変$
やぐでぃん	ヤグディン	名詞サ変*
やけ	ヤケ	名詞サ変*
やざん	ヤザン	名サ形動*
やしょだら	ヤショダラ	名詞サ変*
やしがに	ヤシガニ	名詞サ変*
やじ	ヤジ	名詞サ変*
やじるし	?	単漢字$
やじろべえ	ヤジロベエ	名サ形動*
やす	ヤス	名サ形動*
やすぽん	ヤスポン	名詞サ変*
やすまるとき	休まる時	名詞*
やせいてき	野生的	名詞形動*
やたがらす	ヤタガラス	名詞サ変*
やつ	ヤツ	名サ形動*
やつ	ヤツ	名詞サ変*
やつはし	ヤツは死	名詞$
やつはしね	やつはしね	名詞サ変$
やどりぎ	ヤドリギ	名詞サ変*
やはうぇ	ヤハウェ	名詞サ変*
やばい	ヤバイ	名詞サ変$
やばいやばい	ヤバイヤバイ	名詞サ変*
やべ	やべ	名詞サ変*
やま	ヤマ	名詞サ変*
やま	夜魔	名詞*
やまじゅう	ヤマジュウ	名サ形動*
やまじゅん	ヤマジュン	名サ形動*
やまたのおろち	ヤマタノオロチ	名詞サ変*
やまちゃん	山ちゃん	接尾語*
やまと	ヤマト	名詞サ変*
やまとね	ヤマトネ	名詞サ変$
やまのてせん	山の手線	名詞*
やまわろ	ヤマワロ	名詞サ変*
やめるるぉ	ﾔﾒﾙﾙｫ	名詞サ変$
やら	やら	名詞*
やらせ	ヤラセ	名詞サ変*
やらせないん	やらせないン	名詞サ変*
やらなかい	ヤラナカイ	名サ形動*
やり	ヤリ	名サ形動*
やりたい	ヤリタイ	名サ形動*
やりたいか	ヤリタイカ	名サ形動*
やりたかったら	ヤリタカッタラ	名サ形動*
やりちん	ヤリチン	名詞サ変*
やりまん	ヤリマン	名サ形動*
やる	ヤル	名サ形動*
やるの	ヤルノ	名サ形動*
やれないのと	ヤレナイノト	名詞サ変$
やろー	ヤロー	名詞サ変*
やわ	ヤワ	名詞サ変*
やわじ	ヤワジ	名詞サ変*
やん	ヤン	名サ形動*
やんきーす	ヤンキース	名詞サ変*
やんつん	ヤンツン	名サ形動*
やんでれ	ヤンデレ	名サ形動*
やんでれ	ヤンデレ	名詞サ変*
ゆっきー	ユッキー	名詞サ変$
ゆー	ユー	名詞サ変*
ゆーきりす	ユーキリス	名サ形動*
ゆーきりす	ユーキリス	名詞サ変*
ゆーげんと	ユーゲント	名詞サ変*
ゆーてぃりてぃ	ゆーてぃりてぃ	名詞サ変*
ゆーてぃりてぃ	ユーティリティ	名詞サ変*
ゆうしょうでき	優勝出来	一段動詞*
ゆうな	ユウナ	名詞サ変*
ゆうはく	幽白	名詞サ変*
ゆうふくすぎ	裕福過ぎ	一段動詞$
ゆうもく	有目	名詞サ変$
ゆうゆうはくしょ	幽遊白書	名詞*
ゆうりょうなんで	有料なんで	名詞*
ゆうりょうなんで	有料なんで	副詞*
ゆか	祐花	固有人名$
ゆきじょろう	ユキジョロウ	名詞サ変*
ゆず	ユズ	名詞サ変*
ゆずは	ユズハ	名詞サ変*
ゆだ	ユダ	名詞サ変$
ゆだや	ユダヤ	名詞サ変*
ゆとりご	ゆとり語	名詞*
ゆの	ユノ	名詞サ変$
ゆのに	ゆのに	名詞サ変$
ゆふぃ	ユフィ	名詞サ変*
ゆみ	結実	固有人名$
ゆみますたりー	ユミマスタリー	名詞サ変*
ゆり	ユリ	名詞サ変$
ゆりあん	ユリアン	名詞サ変*
ゆりん	ユリン	名詞サ変$
ゆるいとき	緩い時	名詞*
ゆるげー	ユルゲー	名詞サ変*
ゆるす	ユルス	名詞サ変$
ゆるまん	ユルマン	名詞サ変$
ゆるんぐ	ユルング	名詞サ変*
ゆん	ユン	名詞サ変$
ゆんもってる	ユンモッテル	名詞サ変$
よーこ	ヨーコ	名詞サ変$
よーこ・おの	ヨーコ・オノ	名詞サ変$
よーだ	ヨーダ	名サ形動*
よいが	酔いが	接続詞*
ようか	妖花	名詞*
ようかいぶれす	ヨウカイブレス	名詞サ変*
ようかいぶれす	溶解ブレス	名詞サ変*
ようき	妖鬼	名詞*
ようげ	ようげ	名詞*
ようげ	洋ゲ	名詞サ変$
ようげー	ヨウゲー	名詞サ変*
ようげー	洋ゲー	名詞サ変*
ようげー	用ゲー	名詞サ変*
ようじゅ	妖樹	名詞*
ようじゅ	ヨウジュ	名詞サ変*
ようじゅう	妖獣	名詞*
ようせいの	妖精の	名詞サ変*
ようせいのはね	妖精の羽	名詞*
ようちゅう	妖虫	名詞*
ようちょう	妖鳥	名詞*
ようひと	酔う人	名詞$
よかたあ	ヨカタア	名サ形動*
よが	ヨガ	名詞サ変*
よくなるわけ	良くなる訳	名詞*
よしだそーす	ヨシダソース	名詞サ変*
よしだそーす	吉田ソース	名詞サ変*
よしつね	ヨシツネ	名詞サ変$
よだれ	ヨダレ	名詞サ変$
よつ	ヨツ	名サ形動*
よつ	四	単漢字$
よつんう゛ぁいん	ﾖﾂﾝｳﾞｧｲﾝ	名詞サ変$
よどばし	ヨドバシ	名サ形動*
よどばし	ヨドバシ	名詞サ変*
よな	ヨナ	名詞サ変*
よはね	ヨハネ	名詞サ変*
よもつしこめ	ヨモツシコメ	名詞サ変$
よわってるところ	弱ってる所	名詞$
らっきーどらごん	ラッキードラゴン	名サ形動*
らっぷど	ラップド	名詞サ変*
らー	ラー	名サ形動*
らー	ラー	名詞サ変*
らーでぃっしゅ	ラーディッシュ	名サ形動*
らーめん	ラーメン	名詞サ変*
らーゆ	ラーユ	名サ形動*
らいｎ	ライｎ	名詞サ変*
らいじゅう	ライジュウ	名詞サ変*
らいたー	ライター	名詞サ変*
らいだー	ライダー	名詞サ変*
らいとそう	ライト層	名詞*
らいどう	ライドウ	名詞サ変*
らいぶらり	ライブラリ	名詞サ変*
らいもん	雷門	固有人姓$
らいゆー	ライユー	名詞サ変$
らいら	ライラ	名サ形動*
らいんがん	ラインガン	名詞サ変*
らうる	ラウル	名詞サ変*
らうんだー	ラウンダー	名サ形動*
らうんどしーるど	ラウンドシールド	名詞サ変*
らう゛ぉいｒ	ラヴォイｒ	名詞サ変$
らう゛ぉいる	ラヴォイル	名詞サ変$
らおう	ラオウ	名サ形動*
らくかじゃ	ラクカジャ	名詞サ変*
らくしゃーさ	ラクシャーサ	名詞サ変*
らくしゅみ	ラクシュミ	名詞サ変*
らくらく	ラクラク	名詞サ変*
らくんだ	ラクンダ	名詞サ変*
らぐなろく	ラグナロク	名詞サ変*
らぐらぐらぐら	ラグラグラグラ	名詞サ変*
らけしす	ラケシス	名詞サ変*
らじゃー	ラジャー	名サ形動*
らす	ラス	名詞サ変*
らすたきゃんでぃ	ラスタキャンディ	名詞サ変*
らすと	ラスト	名詞サ変*
らすとえすとっく	ラストエストック	名詞サ変*
らすとりべりおん	ラストリベリオン	名詞サ変$
らすぼす	ラスボス	名サ形動*
らせたー	ラセター	名詞サ変$
らせん	ラセン	名詞サ変$
らそとる	ラソトル	名詞サ変$
らだー	ラダー	名サ形動*
らでぃっつ	ラディッツ	名詞サ変*
らとそる	ラトソル	名詞サ変$
らにはな	らには無	形容詞*
らのべ	ラノベ	名詞サ変$
らはーる	ラハール	名詞サ変$
らばーぐろーぶ	ラバーグローブ	名詞サ変*
らばーしーるど	ラバーシールド	名詞サ変*
らぴゅた	ラピュタ	名サ形動*
らふぁえる	ラファエル	名詞サ変*
らふぃーる	ラフィール	名詞サ変*
らふと	ラフト	名サ形動*
らふぷれー	ラフプレー	名詞サ変*
らぶらぶ	ラブラブ	名サ形動*
らぷそでぃ	ラプソディ	名詞サ変*
らぷらす	ラプラス	名詞サ変*
らぼーな	ラボーナ	名サ形動*
らむ	ら無	接頭語*
らむ	ラム	名詞サ変*
らむちゃん	ラムちゃん	名詞*
らもーんず	ラモーンズ	名詞サ変*
らりったら	ラリッタラ	名詞サ変*
らりあ	ラリア	名サ形動*
らりおす	ラリオス	名詞サ変*
らるく	ラルク	名サ形動*
らるく	ラルク	名詞サ変*
られ	ラレ	名サ形動*
らんか	ランカ	名サ形動*
らんたいむ	ランタイム	名詞サ変*
らんだ	ランダ	名詞サ変*
らんだまいざ	ランダマイザ	名詞サ変*
らんだむ	ランダム	名詞サ変*
らんでぃ	ランディ	名詞サ変*
らんど	ランド	名詞サ変*
らんぷ	ランプ	名詞サ変*
らんぷり	ランプリ	名サ形動*
りｄる	リｄル	名詞*
りゃんなしー	リャンナシー	名詞サ変*
りゅーいち	リューイチ	名サ形動*
りゅーしょん	リューション	名サ形動*
りゅーと	リュート	名詞サ変*
りゅう	リュウ	名サ形動*
りゅう	リュウ	名詞サ変*
りゅうせい	リュウセイ	名サ形動*
りゅうせい	リュウセイ	名詞サ変$
りょーげん	リョーゲン	名詞サ変*
りょーじ	リョージ	名サ形動*
りょーと	リョート	名詞サ変*
りょな	リョナ	名詞サ変$
りっかー	リッカー	名詞サ変*
りっち	リッチ	名詞サ変*
りーが	リーガ	名詞サ変*
りーぐ	リーグ	名詞サ変*
りーじょん	リージョン	名詞サ変*
りーちさ	リーチサ	名詞サ変*
りーちさ	リーチ差	名詞*
りーと	リート	名詞サ変*
りーね	リーネ	名サ形動*
りーふけーぷ	リーフケープ	名詞サ変*
りーぶ	リーブ	名サ形動*
りーよ	リーヨ	名詞サ変*
りあ	リア	名詞サ変*
りある	リアル	名詞サ変*
りあるなら	リアルナラ	名サ形動*
りう゛ぁ	リヴァ	名サ形動*
りう゛ぁい	リヴァイ	名詞サ変$
りう゛ぁうど	リヴァウド	名サ形動*
りか	リカ	名サ形動*
りかーむ	リカーム	名詞サ変*
りかーむどら	リカームドラ	名詞サ変*
りかいでき	理解出来	一段動詞*
りかりす	リカリス	名詞サ変*
りかるど	リカルド	名サ形動*
りかるど	リカルド	名詞サ変*
りかるど・ろぺす	リカルド・ロペス	名詞サ変*
りきっどー	リキッドー	名サ形動*
りごんどー	リゴンドー	名詞サ変$
りごんどう	リゴンドウ	名詞サ変$
りじぇね	リジェネ	名サ形動*
りちゃーず	リチャーズ	名詞サ変$
りでぃあ	リディア	名サ形動*
りでる	リデル	名サ形動*
りでるは	リデルハ	名サ形動*
りと	リト	名詞サ変$
りとる	リトル	名詞サ変*
りとるらびりす	リトルラビリス	名詞サ変*
りのあ	リノア	名詞サ変*
りばうーる	リバウール	名サ形動*
りばうど	リバウド	名サ形動*
りひてる	リヒテル	名詞サ変*
りふじんなこと	理不尽な事	名詞$
りぶつうら	りぶつうら	名詞*
りぷしーはぴー	リプシーハピー	名詞サ変*
りべら	リベラ	名詞サ変*
りめいくした	リメイク慕	ワ行五段*
りめいくしたら	リメイクシタラ	名詞サ変*
りら	利ら	名詞*
りりす	リリス	名詞サ変*
りりむ	リリム	名詞サ変*
りれき	リレキ	名サ形動*
りん	リン	名詞サ変$
りんか	リンカ	名詞サ変*
りんきん	リンキン	名サ形動*
りんぐ	リング	名詞サ変*
りんすかむ	リンスカム	名詞サ変*
りんぷん	リンプン	名詞サ変*
るっく	ルック	名詞サ変*
るー	ルー	名詞サ変*
るーく	るーく	名詞*
るーす	ルース	名詞サ変*
るーず	ルーズ	名詞サ変*
るーとみ	ルート見	一段動詞*
るーに	ルーニ	名詞サ変*
るーふぁす	ルーファス	名詞サ変*
るーむ	ルーム	名詞サ変*
るーる	ルール	名詞サ変*
るーるー	ルールー	名詞サ変*
るーんぐろーぶ	ルーングローブ	名詞サ変*
るーんさーくれっと	ルーンサークレット	名詞サ変*
るーんちゅにっく	ルーンチュニック	名詞サ変*
るーんついーど	ルーンツイード	名詞サ変*
るいじょうこん	累乗今	接頭語*
るく	ルク	名詞サ変$
るしお	ルシオ	名詞サ変*
るしふぁー	ルシファー	名サ形動*
るしふぁー	ルシファー	名詞サ変*
るしふぇる	ルシフェル	名サ形動*
るしふぇる	ルシフェル	名詞サ変*
るちゃ	ルチャ	名詞サ変*
るどん	ルドン	名詞サ変*
るなしー	ルナシー	名詞サ変*
るなしーな	ルナシーナ	名サ形動*
るの	ルノ	名詞サ変*
るぱん	ルパン	名詞サ変*
るふ	ルフ	名詞サ変*
れっ	レッ	名詞サ変*
れっし	レッ死	名詞*
れっするまにあ	レッスルマニア	名サ形動*
れっどありーまー	レッドアリーマー	名サ形動*
れっどありの	レッドアリノ	名サ形動*
れっどそっくす	レッドソックス	名サ形動*
れっどふぇざー	レッドフェザー	名サ形動*
れっどらいだー	レッドライダー	名詞サ変*
れーしんぐらぐーん	レーシングラグーン	名サ形動*
れーしんぐらぐーん	レーシングラグーン	名詞サ変*
れーだー	レーダー	名詞サ変*
れーむ	レーム	名詞サ変*
れあ	れあ	名詞サ変*
れある	レアル	名サ形動*
れいあ	レイア	名サ形動*
れいあっぷ	レイアップ	名サ形動*
れいあん	霊安	名詞*
れいか	麗佳	名詞*
れいかい	冷界	名詞*
れいがん	霊丸	名詞$
れいざー	レイザー	名サ形動*
れいじ	レイジ	名サ形動*
れいぱー	レイパー	名詞サ変*
れいぴあ	レイピア	名詞サ変*
れいぶん	レイブン	名詞サ変$
れいれい	レイレイ	名詞サ変$
れお	レオ	名詞サ変*
れおなーる	レオナール	名サ形動*
れおぱると	レオパルト	名サ形動*
れおん	レオン	名詞サ変*
れき	レキ	名サ形動*
れぎおん	レギオン	名詞サ変*
れぎんす	レギンス	名詞サ変*
れぎんれいぶ	レギンレイブ	名詞サ変$
れくたー	レクター	名サ形動*
れげえ	レゲエ	名詞サ変*
れこあ	レコア	名サ形動*
れざーりんぐ	レザーリング	名詞サ変*
れじ	レジ	名詞サ変*
れじー	レジー	名詞サ変*
れじすとり	レジストリ	名詞サ変*
れすと	レスト	名詞サ変*
れすらー	レスラー	名詞サ変*
れすりんぐしりーず	レスリングシリーズ	名サ形動*
れず	レズ	名詞サ変*
れつにくし	裂肉歯	名詞*
れな	レナ	名詞サ変*
れの	レノ	名詞サ変*
れのっくす	レノックス	名サ形動*
れのん	レノン	名詞サ変*
ればさし	レバサシ	名サ形動*
れび	レビ	名詞サ変*
れぴっしゅ	レピッシュ	名詞サ変*
れぶろん	レブロン	名詞サ変*
れべる	レベル	名詞サ変*
れべるあっぷ	レベルアップ	名サ形動*
れべ゛る	レベ゛ル	名詞サ変*
れぼるーしょん	レボルーション	名サ形動*
れみえる	レミエル	名詞サ変*
れみはー	レミハー	名サ形動*
れみりあ	レミリア	名サ形動*
れん	レン	名詞サ変*
れんごくちょう	煉獄蝶	名詞*
れんじゃー	レンジャー	名詞サ変*
れんとげん	レントゲン	名詞サ変*
れんほう	蓮舫	名詞*
ろっくふぉーる	ロックフォール	名詞サ変*
ろっくぶーけ	ロックブーケ	名詞サ変*
ろっくぶれいかー	ロックブレイカー	名詞サ変*
ろっくまん	ロックマン	名サ形動*
ろって	ロッテ	名詞サ変$
ろっど	ロッド	名詞サ変*
ろっべん	ロッベン	名詞サ変$
ろっぺん	ロッペン	名詞サ変$
ろー	ろー	名詞サ変*
ろー	ロー	名詞サ変*
ろーじあ	ロージア	名詞サ変$
ろーちぇすと	ローチェスト	名サ形動*
ろーどしょー	ロードショー	名サ形動*
ろーどらっしゅ	ロードラッシュ	名サ形動*
ろーにん	ローニン	名詞サ変*
ろーぶ	ローブ	名詞サ変*
ろーれらい	ローレライ	名詞サ変*
ろーんぶろーぞー	ローンブローゾー	名詞サ変$
ろいある	ロイアル	名詞サ変$
ろいやるりんぐ	ロイヤルリング	名詞サ変*
ろう	ロウ	名詞サ変*
ろうにん	ロウニン	名詞サ変*
ろが	ろが	名詞サ変*
ろき	ロキ	名詞サ変*
ろきか	ロキ化	名詞サ変*
ろく	ロク	名詞サ変$
ろくな	ロクな	名詞$
ろくろく	六六	数詞*
ろさかにな	ロサカニナ	名詞サ変*
ろさかにに	ロサカニニ	名詞サ変*
ろしつきー	ロシツキー	名詞サ変$
ろすとわーど	ロストワード	名詞サ変*
ろなうじーにょ	ロナウジーニョ	名サ形動*
ろなうじーにょ	ロナウジーニョ	名詞サ変*
ろなうじーによ	ロナウジーニヨ	名サ形動*
ろなうど	ロナウド	名サ形動*
ろなうど	ロナウド	名詞サ変*
ろにー	ロニー	名サ形動*
ろばすみ	ロバスミ	名詞サ変$
ろびん	ロビン	名詞サ変*
ろふてぃ	ロフティ	名詞サ変$
ろふてー	ロフテー	名詞サ変$
ろべす	ロベス	名詞サ変*
ろべると	ロベルト	名詞サ変*
ろぺす	ロペス	名詞サ変*
ろぼ	ロボ	名サ形動*
ろぼっとのよう	ロボットの用	名詞*
ろぼぴっと	ロボピット	名サ形動*
ろまーりお	ロマーリオ	名詞サ変*
ろまさが	ロマサガ	名詞サ変*
ろむ	ロム	名詞サ変$
ろり	ロリ	名サ形動*
ろり	ロリ	名詞サ変*
ろりか	ロリカ	名詞サ変*
ろりかはまた	ロリカハマタ	名詞サ変*
ろりきゃら	ロリキャラ	名サ形動*
ろりこん	ロリコン	名詞サ変*
ろりしょ	ロリショ	名サ形動*
ろんぎぬす	ロンギヌス	名詞サ変$
わっか	ワッカ	名詞サ変*
わっかで	ワッカデ	名詞サ変*
わー	ワー	名サ形動*
わーす	ワース	名詞サ変*
わーど	ワード	名詞サ変*
わーどな	ワードナ	名詞サ変*
わーぷろ	ワープロ	名詞サ変*
わいぜん	ワイゼン	名詞サ変*
わいばーん	ワイバーン	名詞サ変*
わいばーんめいる	ワイバーンメイル	名詞サ変*
わいぷあうと	ワイプアウト	名サ形動*
わいら	ワイラ	名詞サ変*
わいる	ワイル	名詞サ変*
わいるど	ワイルド	名詞サ変*
わいるどかーど	ワイルドカード	名サ形動*
わいるどかーど	ワイルドカード	名詞サ変*
わいん	ワイン	名詞サ変$
わいんど	ワインド	名詞サ変*
わかいとき	若い時	名詞*
わかるわけ	わかる訳	名詞$
わく	ワク	名詞サ変$
わくわく	ワクワク	名詞サ変$
わさわさ	ワサワサ	名サ形動*
わざまえ	ワザマエ	名詞サ変$
わたなべ	ワタナベ	名詞サ変$
わたる	ワタル	名詞サ変*
わに	ワニ	名詞サ変*
わや	ワヤ	名サ形動*
わら	ﾜﾗ	名詞サ変*
わらえないこと	笑えない事	名詞*
わらえばい	笑えば良	形容詞*
わらわせるため	笑わせる為	名詞*
わる	ワル	名サ形動*
わる	ワル	名詞サ変*
わるーえふ	ワルーエフ	名詞サ変*
われ	ワレ	名詞サ変$
わろす	ワロス	名詞サ変*
わろた	ワロタ	名サ形動*
わろた	ワロタ	名詞サ変*
わろの	ワロノ	名詞サ変*
わん	ワン	名詞サ変$
わんだーどっく	ワンダードック	名詞サ変*
わんつー	ワンツー	名詞サ変*
わんとぅ	ワントゥ	名詞サ変*
わんど	ワンド	名詞サ変*
ん	ン	名詞サ変*
んあ	ンア	名サ形動*
んあっー	ンアッー	名詞サ変$
んじゃ	んじゃ	名詞サ変*
んじゃないか	んじゃないか	名詞サ変*
んす	ンス	名サ形動*
んだ	ンダ	名詞サ変*
んだ	ンだ	感動詞*
んだろ	んだろ	名詞サ変*
んとむ	ントム	名サ形動*
んな	ンナ	名サ形動*
んな	んな	名詞*
んの	んの	名詞サ変*
んると	ンルト	名詞サ変*
